40
40
+-+-+-+-+-+-+-+-+-+-+-+-+-+-+-+-+-+-+-+-+-+-+-+-+-+-+-+-+-+-+-+-+-+-+-+-+-+-+-+-+
|     |   |           |       |     |           | | | |     |   |       |       |
+ +-+ + +-+-+ +-+ +-+ +-+ +-+-+-+ + +-+-+ + +-+-+ + + + + + + +-+-+-+-+ +-+-+-+ +
| | |   | |     | | | |       | | |     | |   | |     | | |       |   | |     | |
+ + + + + + +-+-+ + +-+-+ +-+-+ +-+-+ +-+ + + + + +-+ +-+ + +-+ +-+-+ + + +-+-+ +
| | | | | | |     | |                 |   | |     |       |   | |   |     |   | |
+ + + +-+ +-+ +-+ + + + +-+-+-+-+-+ + + +-+-+-+-+ +-+-+-+-+ + +-+ +-+ + +-+ +-+ +
|   | | | | |   | | | | |   | |   | |   |     |     | |   | |         | |       |
+-+ +-+ + + + +-+ + + + +-+ + +-+ + +-+-+-+ +-+-+-+ + +-+ +-+-+-+ +-+ +-+-+ + +-+
| |   |       | |     |   | |   | |   |       |     |       |   |   | |     |   |
+ + +-+-+-+ +-+ + +-+ +-+-+ + + + +-+ +-+-+ +-+-+-+ +-+ +-+ + + +-+-+-+ +-+-+-+-+
|   | |     |   |   |         | |     | |   | |   | | |   | | |     |   | | |   |
+-+ + + +-+-+ +-+-+ +-+ +-+ +-+-+ +-+-+ + + + + +-+-+ +-+ +-+ +-+-+ + + + + +-+ +
|   | | | |   |     |     |   |           |           |   |     | | | | |     | |
+-+ + + + + +-+-+-+-+-+ + + + +-+-+-+-+-+ +-+-+-+ +-+-+ +-+-+-+ + +-+-+ + + +-+ +
| |                 |   | | |   |       | |   |         |   | | |         |     |
+ +-+ +-+-+-+ +-+-+-+ +-+ +-+-+ + + +-+-+-+-+ + + +-+ + + + + + +-+ +-+ +-+-+-+-+
|       |   | |   |   |     |     | | |   |     |   | |   |   | |   |   |       |
+ +-+ + + +-+ + +-+ +-+-+ +-+ + +-+-+ + +-+ + +-+-+-+ + +-+ +-+ + + + +-+-+-+-+ +
|   | | | | |   | | |       | | | |         | | |   | |   | |   | | |   |   |   |
+-+ +-+-+ + + +-+ +-+-+ + +-+ +-+ + +-+-+-+ +-+ + +-+ +-+-+ + + + +-+-+-+ +-+ +-+
|     |     |       | | | |   |   |   | | |   |     | |   |   | |     |   |   | |
+ +-+-+ +-+-+-+-+ + + +-+ +-+ + +-+ +-+ + + +-+ + +-+ + +-+-+-+ + + +-+ + +-+ + +
|     |     |   | | | | | |   |   | | |         | |       |   | | |     | |     |
+-+ +-+-+ + + +-+-+-+ + + + +-+ + + + +-+ + +-+ +-+ + + +-+ +-+-+-+ + +-+ + + + +
|     | | | | |   |   | | |   | | |   |   | |     | | | |   | |   | |   |   | | |
+-+ +-+ +-+ + + +-+ +-+ +-+ +-+ +-+ +-+-+ + +-+-+-+ + +-+ +-+ + +-+-+-+ +-+-+-+ +
|     | | |           |   | |     | | |   |   | |   | |     | |     |   |       |
+ +-+-+ + +-+ +-+ + +-+ +-+-+-+ +-+ + +-+-+ +-+ + +-+ + + + + +-+ +-+ +-+ +-+ + +
|   | |       |   | | |   |   |   |     |   |   |   |   | | |         |   |   | |
+-+-+ +-+-+ +-+ +-+-+ + +-+ +-+ + +-+ +-+-+ + +-+-+ +-+-+-+ + +-+-+-+-+-+ +-+-+ +
|   | |     |   |   |     | | | |     |   | |       |   | |         |   | |     |
+ +-+ + +-+ +-+-+-+ +-+ +-+ + + + +-+ + +-+ +-+ + +-+-+ + +-+ +-+ +-+ +-+-+ + +-+
|     |   |   |     |       | | | |     | |   | |   | | |     |   |   |   | |   |
+-+ +-+-+ + +-+-+-+ + + +-+-+ +-+-+ +-+ + + +-+-+-+ + + +-+ + +-+ +-+ +-+ +-+-+ +
|         |   | | |   | | |     | |   |   | |       |   |   | |   |       | |   |
+-+-+ + +-+-+ + + +-+ +-+ +-+-+ + + +-+ +-+-+ +-+-+ + + +-+-+-+-+-+-+ +-+-+ + + +
| |   | | |     |     |         |     |   | |   | | | | | |   |         |   | | |
+ + + +-+ +-+ + + +-+-+-+-+ +-+-+ + +-+-+-+ + +-+ +-+-+ + + +-+ +-+ +-+-+ + +-+-+
|   |     |   |   | | | |       | | |   |   | | | |         | |   | | |   |     |
+ + +-+ +-+-+-+-+-+ + + +-+ + + + +-+-+ + + + + + +-+ +-+-+ + + + +-+ +-+-+-+ +-+
| |   |     | | |   |     | | | |       | | | |   |   |   |   | |       |   |   |
+ + + + + + + + +-+ +-+ +-+-+ +-+-+-+ +-+ +-+ +-+ + + + +-+-+ +-+-+ +-+-+ +-+ +-+
| | | | | | | |       | |   | |   | |     | |   | | |     | | |     | | |       |
+-+ +-+ + +-+ +-+-+ +-+ +-+ + + + + +-+ +-+ +-+ + + +-+-+ + +-+ + + + + + + + +-+
| | |   |     |       |         | |       | |       |         | | |       | | | |
+ +-+ + +-+ +-+-+-+-+ +-+ +-+ +-+ +-+-+-+-+ + + +-+ +-+-+-+-+-+ + +-+-+-+-+ +-+ +
| | | | | |     |       | | |   |   | | | |   |   |   |   |     | | |         | |
+ + +-+ + +-+-+ + +-+-+ + + + +-+ + + + + + +-+ + + + + +-+ +-+ + + + +-+ +-+-+ +
|     | |     | |     |   |   |   |     |   | | | | |   |     | |   | |         |
+ +-+-+ + +-+ + +-+-+-+-+-+-+ +-+ +-+-+ + +-+ + + + +-+ +-+ +-+-+ + + + +-+ +-+-+
|     | | |         |   |     | | | |   |   | | | |   |   |     | | | | | |     |
+ + +-+-+-+-+ +-+ +-+-+ + + +-+ +-+ + +-+ +-+ +-+-+-+ + + +-+-+ +-+-+-+ + + +-+-+
| | | | |     | | |     | |     | |   | |   |   | | | | |     |   |   | | | | | |
+ + + + +-+ +-+ +-+ + + +-+ +-+ + +-+ + +-+ +-+ + + +-+-+-+-+ +-+ + + +-+ +-+ + +
| |         |   |   | |       | | | |       |   | | |     | |       |       |   |
+ +-+-+ + +-+-+ + +-+ + + +-+ +-+ + +-+ +-+-+ + + + + +-+ + +-+-+ + +-+ +-+-+-+ +
|   |   |           | | | | |     | |       | |     |   |   |     |   |         |
+ +-+-+-+ +-+-+ + +-+ +-+-+ +-+-+-+ + +-+ + +-+-+ + +-+-+ + + +-+ +-+-+-+-+-+ + +
|       | | |   |   |     |         | |   | |     | |     |     | | |       | | |
+-+ + +-+ + + +-+ +-+-+-+ + + + + + +-+-+-+ +-+ +-+ + + + +-+-+-+ + +-+ + + +-+ +
| | |   |   | | | |       | | | | |     | | | | |   | | |       | |     | |     |
+ +-+ + +-+-+-+ +-+-+-+ + + +-+ +-+-+-+-+ +-+ + +-+-+ +-+-+-+ +-+-+ + +-+ +-+ +-+
|     | |         |     |     | |           | | |   |     |   | |   | | |   |   |
+-+-+ + +-+ + + +-+-+-+-+ + + +-+ +-+-+-+ +-+ + + + + + +-+-+ + +-+-+ + + +-+-+ +
|     |     | |     |     | |     |   |   |       |   | |     |     | |   |     |
+ + + +-+-+-+ + +-+-+-+ +-+ +-+-+-+-+ +-+-+ + +-+-+-+-+-+-+-+ +-+ +-+-+-+-+-+ +-+
| | | |   |   |   | | | |   |   | | |   | | |   |         |   |           |     |
+-+-+-+-+ +-+-+ + + + +-+ +-+ +-+ + + +-+ + +-+-+-+-+-+-+ +-+-+ +-+-+-+ +-+ +-+ +
| | |     |     | |   |       | | | |                       | | | | | |     |   |
+ + +-+ +-+-+ + +-+ +-+-+-+-+ + + + + +-+ +-+ +-+ +-+-+-+-+-+ +-+ + + +-+ +-+-+-+
| |           | | |           |       |     | | |   |   |       |         |   | |
+ +-+-+-+-+-+ +-+ +-+ + + +-+ + +-+ +-+-+-+ +-+ +-+ + +-+-+ + +-+ + +-+-+-+-+ + +
|   |   | | |   |   | | |   | |   |   |       |     |   |   |     |       |     |
+-+ +-+ + + + +-+ +-+ +-+-+-+ +-+-+-+-+-+ +-+-+ +-+ + + +-+-+-+ +-+-+ + +-+-+ +-+
|                   | | | | | |   |       |   |   | | | |   |   |   | | |       |
+-+-+ +-+ +-+-+ +-+-+-+ + + + +-+ + +-+-+ + + +-+ + + +-+ + +-+ +-+ +-+ +-+ + +-+
|     |       |   |   |     | |       |   | | |   | |   | | | |   |       | |   |
+ + +-+ +-+-+-+ +-+ + + +-+ + +-+ + +-+ + + +-+ +-+ + + +-+ + + + +-+ +-+-+ +-+ +
| |   | |         | |   |       | |   | |   |     |   |   |     |   |       |   |
+-+-+-+-+-+-+-+-+-+-+-+-+-+-+-+-+-+-+-+-+-+-+-+-+-+-+-+-+-+-+-+-+-+-+-+-+-+-+-+-+
