5
5
+-+-+-+-+-+
| |       |
+ +-+ +-+ +
| |   |   |
+ +-+-+ + +
|       | |
+ + +-+-+-+
| |       |
+ + +-+-+ +
| | |     |
+-+-+-+-+-+
