5
5
+-+-+-+-+-+
| | |   | |
+ + +-+ + +
|         |
+-+-+ +-+ +
|     |   |
+ + +-+-+ +
| | |     |
+-+ + +-+-+
|   |     |
+-+-+-+-+-+
