50
50
+-+-+-+-+-+-+-+-+-+-+-+-+-+-+-+-+-+-+-+-+-+-+-+-+-+-+-+-+-+-+-+-+-+-+-+-+-+-+-+-+-+-+-+-+-+-+-+-+-+-+
| |     |               | | | |     |   | |     |     |   |       |   |   | |               |   |   |
+ + +-+ + +-+-+ +-+-+ +-+ + + +-+ +-+-+ + + +-+ +-+ + +-+ +-+ +-+-+ + +-+ + +-+-+-+ +-+ + +-+ + +-+ +
|   |         |     |   |       |   |     |   | |   |   | |     |   |   | |   |   | |   | |   |   | |
+-+-+ +-+ + + + +-+ +-+-+-+-+ +-+ +-+-+ +-+ + +-+-+ +-+-+ +-+-+ + +-+-+ + + + + +-+-+ +-+-+ +-+ +-+ +
|     |   | | | |   | |         |   |     | |           | |     | |       | | |   |     |   | | | | |
+ + +-+-+-+ + +-+-+-+ +-+ + +-+ + +-+-+ + +-+-+-+-+-+-+ + +-+-+ +-+ +-+-+-+-+ +-+ +-+-+ + + + + + + +
| |   |   | |     |       |   | |   |   |           |   |         |   |   |   |     |     |   | | | |
+-+ +-+ + +-+ +-+ + +-+ +-+ + + +-+ + + + +-+-+ +-+ +-+ +-+-+-+-+ + +-+-+ + + +-+ +-+-+-+ +-+-+-+ + +
|   |   |     |   | |   |   | | |     | | | |   | |   |           |         | | |   | |   |         |
+ +-+-+-+ +-+ + +-+-+-+ + + + + +-+-+-+-+ + + + + + + + +-+ + +-+ +-+ + +-+-+ + +-+ + +-+ +-+ +-+ +-+
|     |   |   |     |   | | | | |           | | |   |   | | | | | |   | |   |   |   | |     |   |   |
+ +-+-+ +-+-+-+-+ +-+-+-+-+ + +-+-+-+-+-+-+-+-+-+ +-+ +-+ + +-+ +-+-+ +-+ +-+ + + +-+ + +-+-+ +-+ + +
|     | |       |   |       | |       |   | |     |       |     | |   |   |   | | |     | | |   | | |
+ +-+-+-+ +-+-+-+-+ +-+ +-+-+-+-+ +-+ + +-+ + +-+-+-+ + + +-+ + + +-+ +-+ + +-+-+ +-+-+ + + +-+-+ + +
| |     |   |     |                 | |   |   |   |   | | |   |   |     |                   | |   | |
+-+-+ + + + +-+ +-+-+ +-+ + + +-+-+ +-+-+ + + + +-+-+-+-+-+ + +-+-+ + + +-+ +-+-+ +-+ +-+ +-+ +-+ +-+
|     |   |   |         | | | |   | |       | |     | |     | | | | | |   |   | |   | |         | | |
+-+ +-+ + +-+ + +-+-+ +-+-+ +-+ + + + +-+ +-+-+ +-+ + +-+-+-+-+ + +-+-+ +-+-+-+ +-+-+ +-+-+ +-+ + + +
|   |   | |   | | |       | | | |       |       | | |     | |   | |     | | |         |   | |       |
+-+ + + +-+-+ + + +-+-+-+-+-+ +-+ +-+ +-+-+ +-+-+ + +-+ +-+ +-+ + +-+ + + + +-+ +-+ + + +-+-+ +-+-+ +
|   | | | | | |   |   |       | | |     | |   | | |   | | |   | | | | |     |   | | | |     |   |   |
+ + +-+-+ + +-+ + +-+ +-+ + +-+ +-+ + +-+ +-+ + + + + + + +-+ + + + +-+-+ +-+ +-+ +-+-+-+ +-+-+-+-+ +
| |         |   | |   | | |   |     | |   |   |   | |       |   |         | |   | |     |   |       |
+-+ +-+ +-+-+ +-+-+-+ + + + + + +-+ +-+ +-+-+ +-+ +-+-+-+ + + +-+ + +-+-+-+ +-+ + + +-+ + +-+-+ + + +
| | |   |   | |     |   | | | | |         |   |   |       |     | | | | |   | |   | |         | | | |
+ + +-+-+-+ + + +-+-+ +-+ + +-+-+ + + +-+-+ +-+-+ +-+-+-+-+-+ +-+ +-+ + +-+ + +-+-+ +-+ +-+-+-+-+ +-+
|       |     |   |     | |     | | | | |     | |     |     |       |           |   |     |         |
+ + +-+-+ +-+ +-+ +-+ + +-+ + +-+-+-+ + +-+-+ + +-+-+ + + + +-+-+-+ +-+-+ + +-+ +-+ +-+ +-+-+-+-+ +-+
| | | | |   |   |     |     |   | |         | | | |     | | |   |     |   | | |     |   |   |   |   |
+-+ + + + +-+-+ + +-+-+-+-+-+ +-+ + + + +-+-+-+ + +-+-+ +-+-+-+ + +-+ +-+-+-+ +-+ +-+ +-+ + + + + +-+
|         | |   |   |   |         | | | |         |             |   | | |   |     | |   | | | | | | |
+-+-+-+-+ + + +-+-+ + + +-+ +-+-+-+-+-+-+-+ + + +-+-+ +-+ + + + + +-+ + + +-+-+ +-+ + +-+-+ + + + + +
| | |     |         | | |         | | | |   | | |   |   | | | |   |     | |     |       | |   |     |
+ + +-+ + +-+ + + +-+-+ + +-+ +-+ + + + +-+ +-+-+-+ +-+ + +-+ +-+ + + +-+ + + +-+-+ +-+ + +-+-+ +-+ +
|       | |   | |     | | |   |         |     |     | | | |     | | |   |   | |   | | |   | |   | | |
+-+-+-+-+-+ +-+-+ + +-+ + +-+ +-+ + + +-+ + +-+ +-+ + +-+-+-+-+-+-+-+-+ +-+ + +-+ + + +-+ + +-+ + + +
|   |     | | | | | |   |   | |   | | | | | |   | |   |               | | | |     | | | |   |   | | |
+ + +-+-+ + + + +-+-+ +-+-+-+ + +-+ +-+ +-+ + +-+ +-+ + +-+ + +-+ +-+ + + +-+ + +-+-+ + + + + + + + +
| |       |     | |         | | |   |   |     |   |   | | | |   | | | | |     |     | |   |   |   | |
+ + +-+ + + + +-+ +-+ +-+ +-+-+ +-+-+-+ +-+-+ + + +-+-+ + +-+-+-+ + + +-+-+-+ +-+-+ + + + + + +-+-+-+
| |   | |   | | |     | |   |   |   |       | | | |     | | |   | |       |     |     | | | |   | | |
+-+-+ +-+-+-+-+ + +-+ + + +-+ +-+-+ +-+ +-+-+ + +-+ + +-+ + + + +-+ +-+-+ + +-+-+-+-+-+ +-+-+-+ + + +
| |   |   | | |   | | |     |       |   |   |       |   |   | |   |     | |         |   | | |       |
+ + + + +-+ + + +-+ + +-+-+-+ +-+-+-+-+ +-+ + +-+-+ + + +-+ +-+ +-+ +-+-+ +-+ +-+-+-+-+-+ + + +-+ +-+
|   | |       | |       |   | |     |         | | | | |       |     |   | | | |   |   | | |   |     |
+-+ +-+-+ +-+-+-+-+ +-+ + +-+-+ +-+ +-+ +-+-+-+ + +-+ + +-+-+-+ + +-+ + +-+ +-+ + +-+ + + + +-+-+-+ +
|       |   | |   | | |           |   | |   |       | |     |   |     |     |   |       |   | |     |
+ +-+-+ + +-+ + +-+ + + + + +-+-+ + + +-+-+ +-+ + + +-+-+-+-+-+-+ +-+-+-+ + +-+ +-+ + +-+-+ + +-+ +-+
| |   | |       | |   | | | |     | | | |       | | |   | | | |     |     | |     | |         | |   |
+-+-+ + +-+ + +-+ + + +-+-+ +-+-+-+ +-+ +-+ +-+-+-+-+ +-+ + + +-+-+ +-+-+ +-+-+-+ + +-+ + +-+-+ +-+ +
|     | |   | |     | |   | |     |     | | |   |               |     | |   |     | |   | |     |   |
+ +-+-+ + +-+-+-+-+ +-+ + +-+-+ +-+ + +-+ + +-+ +-+ +-+-+-+-+ +-+-+ +-+ +-+ + + +-+ +-+-+ +-+ +-+-+-+
|           | |     | | |       |   |       |       | |     |   |     | |     |   | |     |         |
+ +-+-+ +-+ + +-+ +-+ +-+ +-+-+-+ +-+-+-+-+ +-+-+-+ + + +-+ +-+-+-+ +-+ +-+-+-+ +-+-+ +-+ +-+ +-+ + +
|     |   |   |   |   |   | |       | |     |   |         |   | | | |         |     | |   |   |   | |
+ +-+-+-+-+ +-+ +-+ +-+ +-+ +-+ + +-+ +-+ + + +-+ +-+ +-+-+-+ + + + + +-+-+-+-+-+ +-+-+-+ +-+-+ + + +
| |           |   |   |   | |   |       | |   |   |   |   | |     |         | | | |       |     | | |
+ + +-+ + +-+ +-+-+ +-+-+ + + + +-+-+ +-+-+-+ +-+-+ + + +-+ +-+-+ + +-+-+-+-+ + +-+-+-+ + + +-+-+-+-+
| | | | | |   | | |     |     | |   |     |   | | | |     |   |     |   |         |   | |         | |
+ +-+ + +-+-+ + + + +-+-+ +-+ +-+-+ +-+ + +-+ + + + + + +-+-+ +-+ +-+ +-+-+ +-+ + + +-+-+-+ +-+-+-+ +
| |         | | |     |   |   |     |   |   | |     | |   | |       |       |   |       |   |     | |
+-+-+ +-+ +-+-+ +-+ + + +-+ +-+ + +-+-+ +-+-+ +-+-+-+ + +-+ +-+-+ +-+ + +-+ +-+-+-+-+-+ + + +-+ +-+ +
| |   |   | | |     |     | |   |   | |     |   |     | |       |   | | |     | | |     | | | |     |
+ + +-+-+ + + + + +-+-+ +-+-+ +-+ +-+ + + + + +-+ +-+ +-+-+-+ + + +-+-+ +-+ + + + +-+-+-+-+ + + +-+-+
|   | | | | |   | |             |   | | | | | | | |       |   | | | |   |   |       |   |   |       |
+ +-+ + +-+ +-+-+-+ +-+-+-+-+ +-+-+-+ +-+ +-+-+ +-+-+-+ + + +-+-+ + + +-+-+-+-+-+ + + +-+ +-+-+ +-+-+
|     |       |       |     |         | |   |           | |   |         |   |     |     | |       | |
+-+-+ + +-+-+-+-+ + +-+-+-+ + +-+-+-+ + +-+ + + + +-+ +-+-+-+ +-+-+-+-+-+-+ +-+-+-+-+-+-+ +-+ + +-+ +
|                 |     | |       |   |     | | | |   |   |       |         | | | |   |       |   | |
+ +-+-+ + + +-+ + +-+ +-+ + + +-+-+-+-+-+ +-+ +-+ +-+ + +-+ +-+ +-+-+ + + +-+ + + +-+ +-+-+-+-+ +-+ +
|     | | |   | | |     |   |     |   | |   |   | |           | | |   | |     |     |   | |   | |   |
+ +-+-+-+-+ + +-+ +-+-+-+-+-+ +-+-+ + + + +-+ + +-+-+ +-+-+-+-+ + + +-+-+ +-+ +-+-+ +-+ + +-+ + +-+ +
| | | |   | | | | |             |   |     |   | |           | |       |     |   |     |   |     |   |
+-+ + +-+ + + + +-+-+ + +-+-+-+ +-+-+-+-+-+ + +-+-+-+ +-+-+-+ +-+-+-+ + + + +-+-+-+ + +-+ + +-+-+-+ +
| |   |     |       | |   |       |     | | | |     |       |         | | |   |   | |     |         |
+ +-+ +-+ +-+ +-+-+ + +-+ +-+-+ +-+-+ +-+ +-+ +-+ + +-+-+ + +-+-+-+-+ +-+ +-+-+ +-+-+-+ +-+ + + +-+ +
|   | |   |       | | | |   |     |   |     | |   |     | | | |   |     |   |   |     | |   | | |   |
+ + + +-+-+ + + +-+ +-+ +-+-+ + +-+-+ + +-+-+ + + +-+ + + +-+ +-+ + +-+ +-+ +-+ +-+ + + + +-+-+-+ +-+
| |   |     | | |     | |     |       |     | | |   | | | | | | |   |     | | |     |         |   | |
+ + +-+-+ +-+ +-+-+ + + +-+ +-+-+-+ + + +-+ +-+-+ +-+ +-+ + + + +-+-+ + + +-+ +-+-+-+-+ + + +-+ + + +
| | |     | |   |   | |     | |     | | |   | | | |         |   |     | |       |   |   | | |   | | |
+-+ + +-+-+ +-+ +-+-+ + +-+-+ + +-+-+ + +-+ + + + + +-+-+-+ + + +-+ +-+-+-+ + + + +-+-+-+ + +-+ + + +
|   |   |         |   |     |   | |       |   |   |   |   | | |     | |   | | |     |     | | | |   |
+-+ + +-+-+ +-+ +-+-+-+ + +-+ +-+ + +-+-+-+ +-+-+-+ +-+-+ + +-+-+ +-+ +-+ +-+-+ +-+ + +-+-+-+ + +-+ +
|     | |   |   |     | | |   | | | |   |   | |     | |   | |   | | | |         | | |   | | |     | |
+-+ + + +-+ +-+-+-+ +-+ +-+ + + + +-+ +-+ + + + +-+-+ + +-+-+-+ +-+ + +-+ +-+ +-+ +-+-+-+ + +-+-+-+-+
|   | | |   |     | |     | |   |   |   | |   |   | |   |             | | |         |     | | | |   |
+ +-+-+ +-+-+ + + + +-+-+-+ + + +-+ + + + +-+-+ +-+ + +-+-+ +-+ + + +-+ +-+-+ +-+-+ +-+-+ + + + + +-+
|     |   | | | | | | | |   | | | |   |   |   |   |         | | | |   |   |   | | | |     |     |   |
+-+-+ + +-+ + +-+ + + + +-+-+-+ + +-+-+-+ + + +-+-+-+-+ + +-+ + + +-+ +-+ + +-+ + +-+-+ +-+-+-+ + +-+
|     |   |     |   |     | |   |           |   |     | |   |   |   |     | |   | |   |         |   |
+-+-+ +-+ + +-+-+-+-+-+ +-+ + +-+-+-+ +-+-+-+-+ + +-+-+-+-+ +-+-+ +-+ +-+-+ + + + + +-+ +-+ +-+-+-+ +
| | |               | |   |       |     |     |         |   |       | |   |   |         |   |       |
+ + +-+ + +-+ +-+-+-+ + + +-+-+ + + +-+-+-+ + + +-+-+-+ + + + + +-+ +-+-+ + +-+ +-+ +-+-+ + + +-+ +-+
|   |   | | |     | |   | |     | | | |   | | | | | |   | | | | |     |   | | |   | |   | |     |   |
+-+ +-+ + + +-+ + + +-+ +-+ + +-+-+ + +-+ +-+ + + + +-+ +-+-+-+-+-+ +-+ + + + +-+-+ +-+ +-+-+-+ + +-+
|       | |     | |     |   | |         |             |   | | |   |     | |       |   |   |     |   |
+ +-+ + + + + +-+ + + + +-+-+ +-+ +-+-+-+-+ + +-+ +-+ + +-+ + + + +-+-+-+ + +-+-+-+-+ + + + +-+-+ + +
|   | | | | | |     | | |     |         |   | |     | |         |   |           |       | | |     | |
+-+-+-+-+-+-+-+-+-+-+-+-+-+-+-+-+-+-+-+-+-+-+-+-+-+-+-+-+-+-+-+-+-+-+-+-+-+-+-+-+-+-+-+-+-+-+-+-+-+-+
