20
20
+-+-+-+-+-+-+-+-+-+-+-+-+-+-+-+-+-+-+-+-+
| |     |   | |     |       |       |   |
+ +-+ + + +-+ + + +-+ +-+ +-+-+-+-+ +-+ +
| | | |   | |   |       |   | |   |     |
+ + + + +-+ + + + + +-+-+ + + +-+ +-+ + +
|     |   | | | | | |     | |         | |
+-+ + + + + +-+ +-+-+ + +-+ + +-+-+-+-+-+
|   | | |     | |     | |     | |   |   |
+ +-+ + + + +-+-+-+-+ +-+-+-+-+ + + +-+ +
| | | | | | |   |     |     |   | | | | |
+-+ + +-+ + + +-+-+-+ + +-+ + +-+ + + + +
| |   |   |             |         | |   |
+ +-+-+ +-+-+ +-+-+ + + + + + +-+ + + +-+
| |       |   |   | | | | | |   | | |   |
+ + +-+-+ +-+-+ +-+-+-+-+-+ +-+-+ + + + +
|       |         |     |   | | | |   | |
+ + +-+-+ +-+ +-+-+-+-+ + +-+ + +-+-+-+-+
| |   |     | | | | | |   |     |     | |
+-+-+-+ +-+ +-+ + + + + +-+-+-+ + + +-+ +
| | |   |   | | | | | |       | | |   | |
+ + +-+-+-+ + + + + + + +-+ +-+ + +-+-+ +
|         |   |     |   | |   |         |
+-+-+ + +-+ +-+-+ +-+-+ + +-+ +-+ +-+-+-+
| |   | |   | |       | |   |   | |     |
+ + +-+-+-+-+ + +-+ + + +-+ +-+-+ + + +-+
|           |   |   |         |     |   |
+ +-+ +-+ + +-+ +-+-+ +-+ +-+-+-+-+-+-+ +
|   | | | |       |   |           | |   |
+-+-+ + +-+-+ +-+ +-+-+ +-+-+-+ + + + +-+
|   |   |   | |   |       | | | |       |
+-+ +-+ +-+ + +-+-+-+ + + + + +-+-+ +-+ +
|         |     |     | | |   |       | |
+-+ + +-+ +-+ +-+ +-+-+ + +-+ +-+-+ +-+ +
|   | |   |     |     | | |     |     | |
+-+-+ +-+ + + + +-+-+-+-+-+-+-+ + + + +-+
|       | | | |     |     |   | | | |   |
+ +-+-+-+ + +-+ + +-+ +-+ + +-+ +-+ +-+ +
| |       | | | |     | | |         |   |
+ +-+ +-+ + + + +-+ + + + +-+-+ +-+ +-+-+
| |     | |   | |   | |     |   |       |
+-+-+-+-+-+-+-+-+-+-+-+-+-+-+-+-+-+-+-+-+
