50
50
+-+-+-+-+-+-+-+-+-+-+-+-+-+-+-+-+-+-+-+-+-+-+-+-+-+-+-+-+-+-+-+-+-+-+-+-+-+-+-+-+-+-+-+-+-+-+-+-+-+-+
| |   |   |     |   | | | |         | |         |       |       |       |             | | |   |   | |
+ + +-+ +-+-+ + + +-+ + + + + +-+-+-+ +-+ +-+ +-+-+-+-+ + + +-+-+ +-+ +-+-+ + +-+-+ +-+ + +-+ + +-+ +
|       |     |   |     | | |     |   |     |   |   |     | |   | | |   |   |   |     | |           |
+-+ +-+-+ + +-+-+-+-+-+ + +-+ +-+ +-+ + + + +-+-+-+ + + + +-+ + +-+ +-+ + +-+-+-+-+-+-+ +-+-+-+-+ + +
|         | |     |         | |         | | |       | | |     | |         |         | |       |   | |
+ +-+ +-+-+ + +-+ + +-+-+-+ + +-+ +-+-+-+-+ +-+-+-+ + +-+ +-+ + +-+ + + +-+ + +-+-+-+ +-+-+-+ +-+ +-+
|   | |         | |     |   | | | |     |   |     | |   | | | |     | | |   |       |       |       |
+ + + +-+ +-+-+ + +-+ +-+-+ + + +-+ +-+-+-+ +-+-+ + + + + + + + +-+ + +-+-+-+-+ +-+-+-+-+-+ +-+ +-+ +
| | |   | |   | |         |     |     | |   | |   |   | |   | | |   |   | |     | |     | |   |   | |
+-+-+-+-+-+-+ + +-+ +-+-+-+-+ +-+ +-+-+ +-+-+ + +-+ +-+-+-+-+ +-+ + +-+ + + +-+-+ + + + + +-+ +-+ +-+
| |         |   | |   | |           |   | |         | | |   |   | | |         |     | |       |   | |
+ +-+-+-+ +-+ +-+ +-+-+ +-+-+-+ +-+ + + + +-+-+-+-+-+ + + + +-+ +-+ +-+ +-+-+-+ +-+ +-+-+ +-+ + +-+ +
| |     |   |   | |     |   |     |   | |     |         | |   | |     | | |   | | | |   | | | | |   |
+ + + + +-+ + + + + + + +-+ +-+-+-+ +-+-+ +-+ + +-+ + +-+-+ + +-+ +-+-+-+ + + +-+ + +-+ +-+ + + + +-+
|   | | |   | |   | | |   | |       | | |   | |   | |   | | |   |   |     | |   |   |   | |     |   |
+-+ +-+-+ + +-+-+-+ +-+ + + +-+-+-+ + + + +-+ + + +-+ + + + +-+-+-+ + +-+-+ +-+ + +-+ +-+ + +-+ + +-+
| |   |   |     |     | |       |   |       |   |   | | |   | |   |           | | | | | |     |     |
+ + +-+-+-+-+ + +-+ + + +-+ + +-+ +-+-+ +-+ +-+-+-+-+ + + +-+ + +-+-+-+ +-+-+-+-+ + + + + +-+ + +-+-+
|       | |   |   | | |   | | |           |   |       |     |   |         |           |     | | |   |
+ +-+ +-+ +-+-+ +-+ +-+-+-+-+ + +-+-+-+ +-+-+ +-+ +-+ + +-+-+-+ +-+ +-+-+ +-+-+-+ + + +-+ +-+ + +-+ +
| | | | |   |     | |   |   |   |   |       | |   | | |           | |       |   | | |   | | | |     |
+ + + + + +-+ +-+ + + +-+ +-+-+-+ +-+-+-+-+ +-+ +-+ + + +-+-+-+-+-+ + +-+ + + + + + + + +-+ +-+ +-+ +
| | |   | |   |     |     | |   |         | | |     | |         |   | | | |   |   | | | | |       | |
+-+ + +-+ +-+-+ + +-+ +-+-+ +-+ + +-+-+ +-+-+ + + +-+ +-+-+ +-+-+-+-+-+ + + +-+-+-+-+ +-+ + +-+-+ + +
|   |   |       |       |   |     |       |   | |   | |   | | | | |       |         |   |     |   | |
+-+ + +-+-+-+-+-+ +-+ + + +-+-+ +-+ + +-+-+-+ + +-+ +-+ +-+-+ + + + +-+-+ + +-+ +-+-+ +-+ +-+-+ +-+-+
|     | |   |       | |     | |   | | |   |     |   |     |     |   |   | |   |     |   |   |       |
+-+-+ + + +-+ +-+ +-+-+ +-+-+ + +-+ +-+ + +-+ +-+-+-+ +-+-+-+ +-+-+ + +-+-+-+-+-+-+-+ +-+-+-+-+ +-+-+
| | |   | | |   | | |   |   |   | |     | |     |     |   | |   |   | |     |     |   | |           |
+ + +-+ + + +-+-+ + +-+-+ + +-+ + +-+-+-+-+-+-+-+-+-+ +-+ + +-+ +-+-+ + + +-+-+-+ +-+ + + +-+-+-+-+-+
|   |   |             |   |       |   |           | |     |             |   | |       | |   |     | |
+-+ + +-+ + +-+-+ +-+-+-+-+-+-+ +-+ + + +-+-+ +-+ + +-+-+ + +-+ +-+-+-+ + + + +-+ +-+-+ + +-+ +-+ + +
|   | | | | | |     |       | |     |       | | |   |       |   | | | | | |   |   | |     | | |     |
+-+ + + +-+-+ + +-+-+-+-+ + + + +-+-+-+ +-+-+ + +-+-+ +-+ +-+ + + + + +-+-+-+ +-+-+ + +-+ + + +-+-+-+
| |   |         | |       |   |   |     | |   |   |   | |   | | |         |   |       | | |         |
+ +-+ +-+ +-+ +-+ +-+ +-+-+-+-+-+ + +-+ + +-+ + + +-+-+ + +-+-+-+ + +-+ + + +-+-+-+ + + + +-+ +-+-+-+
|       | | |   | |       |   | | | |     | |   |   |   |   | |   |   | | |   |     | |       |     |
+ +-+-+ + + +-+ + + +-+-+ + +-+ +-+ +-+-+ + +-+-+-+-+-+ +-+ + +-+ +-+-+ +-+ +-+ + + +-+-+-+ + + +-+ +
| |     |   |   | | | |     |           |   | | |   | |           | | | |   |   | |     |   |     | |
+-+-+-+ +-+-+ +-+ + + +-+ +-+-+ + +-+ +-+ +-+ + + +-+ + +-+-+-+-+-+ + + +-+-+-+-+-+-+-+-+ +-+-+-+ +-+
| |   | |   |   |     |       | | | | | |   |           |       | |   | | |   | |       | | |       |
+ + +-+ + +-+ +-+-+ +-+-+ +-+-+ + + +-+ +-+-+-+-+-+ +-+ +-+ + +-+ + +-+-+ + + + + +-+-+ +-+ +-+-+-+ +
| |   |               |   |   | | | |       | |   | |     | | |   | | | |   |         | |   |       |
+ + +-+ +-+-+ +-+ +-+-+ +-+ + + + + +-+ +-+-+ +-+ + + + + +-+ + + + + + +-+-+-+-+ +-+-+-+-+ + + +-+ +
|         |     | | |   |   | | |     |           | | | | |     |   |     | |           |   | |   | |
+-+ +-+-+ + +-+-+-+ +-+ + +-+ + +-+ +-+ +-+-+-+-+ +-+ +-+-+-+-+ +-+ + +-+-+ +-+-+ + + + + + + +-+ +-+
|       | | |           | | |   |       |   |       | | |   |     | | | |   |   | | | |   | | |   | |
+ +-+-+-+ +-+-+-+-+ +-+-+ + + + +-+ +-+ + + +-+ +-+ + + + + + +-+-+ + + +-+ + +-+ +-+ + + +-+ + + + +
|     |   |   |   | | |     | | | | |   | |     |     |   |   |   | |     | |   | |   | | |   | |   |
+-+ + +-+-+-+ + +-+ + + + +-+ +-+ +-+ +-+-+ + +-+-+-+ + +-+-+-+-+ +-+-+-+ + + +-+-+ + +-+-+ +-+ +-+-+
|   | | |     |         | |     |   | | | | | |                   |       |       | |   |   |       |
+-+ +-+ + + +-+ +-+ +-+ +-+-+-+ + +-+-+ + +-+-+-+-+ +-+-+ + +-+-+-+-+-+ +-+ +-+-+-+ + + + +-+-+-+-+ +
|       | |   | |   |         |         |   |   |     |   |   |   |     | |       | | | | | |   |   |
+ +-+-+-+ + + +-+-+ +-+-+ +-+-+-+-+ + + + +-+-+ + + + +-+-+-+ +-+ + +-+ + + + + +-+ +-+ +-+ +-+ +-+ +
|   | | | | | |   | |   | | | | |   | | |         | | |   | |     |   |   | | | |     | | |       | |
+ + + + +-+-+ +-+ +-+ +-+-+ + + +-+-+-+-+-+ +-+ + +-+ + +-+ +-+ +-+-+-+ +-+-+ +-+ +-+ +-+ + +-+ +-+ +
| |   | | |         | |       |       |   |   | | | |   |   |     |     |   | |   |           | | | |
+-+-+ + + + +-+ +-+-+ +-+ +-+ +-+-+-+ + +-+ +-+-+ + +-+-+ +-+ +-+ +-+ +-+ +-+ +-+-+ + + +-+ + +-+ + +
| | | | | | |   |   |   | | | |   |     |       |   |       | |   |       |   |     | | | | |   |   |
+ + +-+ + + + + + +-+ +-+ + + + +-+ + +-+-+ + + + +-+ +-+-+ +-+ +-+-+-+ + +-+ +-+-+-+ + + +-+ +-+ + +
|     |   | | |     |   | |     | | | |     | | |   |   |   |   | |     |     |     | | |   |     | |
+ + +-+ + +-+-+-+ +-+-+ + + +-+ + + + + + +-+-+ +-+-+-+-+ + + +-+ +-+ + + +-+ +-+ + + +-+ +-+-+-+ +-+
| |     |   |       |     | |   |   |   | |   | | | | |   | |         | |   | |   |         |   |   |
+-+-+ +-+ + +-+ +-+ +-+ +-+ +-+-+-+-+ +-+-+-+ + + + + +-+ +-+ + +-+ +-+-+-+-+ +-+ +-+ + +-+-+ +-+-+-+
| |   |   | | | |   | | |   |         | |             | | |   | |   | | |         | | |     | | |   |
+ +-+ +-+ +-+ + + + + + +-+-+ +-+ +-+ + +-+ +-+ +-+-+-+ + + +-+-+-+-+ + +-+-+-+ + + +-+-+ +-+ + + +-+
| | |   | |   | | | | | |     |     |   | | |     |       |   | |   |       | | |   | |     |     | |
+ + + +-+ + +-+ + +-+ + +-+ +-+-+ + + + + +-+ +-+ +-+ + + +-+ + +-+ + +-+-+ + +-+-+-+ +-+ + + + + + +
|   |   |   |   |         |     | | | |   | |   |   | | |     | |   |   |   |         |   |   | |   |
+-+ + +-+-+-+ +-+-+ +-+ + + +-+-+ + +-+-+ + + +-+-+-+ + +-+-+ + + + + +-+-+ + +-+-+ +-+ +-+-+ +-+ +-+
|             |   | | | |   | | | |   |     | |     | |     | |   |   | |     |         | |   | |   |
+ +-+ +-+-+ + +-+ + + +-+-+-+ + +-+ +-+ +-+ + + + +-+ +-+-+-+ + + + + + +-+-+-+ + +-+ + + +-+-+ + + +
| | | | |   |   | | | | | | |     |   | |   | | | |       | | | | | |     |   | | |   |       |   | |
+-+ +-+ + +-+-+-+ + + + + + + +-+-+ + + +-+-+-+ + + + +-+ + + +-+ +-+-+ +-+ +-+-+-+-+ +-+-+-+ +-+-+-+
|     | |   |         | | |         | | |     | |   | | |   | |   | |   |     |       | |   |     | |
+-+-+ + +-+-+-+-+-+ + + + +-+ +-+-+ + + + +-+-+-+ +-+-+ + +-+-+-+-+ +-+ +-+-+ + +-+-+ + + +-+-+ + + +
|       |   |       |     |   |   | | | | |   | |   |   |   | |     | |     | | |             | | | |
+-+-+ + +-+ +-+ +-+ + + + +-+-+ +-+ + +-+ +-+ + +-+-+-+ +-+ + +-+ +-+ +-+ + + + + + +-+ +-+ +-+ +-+ +
|   | |   |     |   | | |     | | | |   |               | | | |       |   | | | | | | | |   |       |
+ +-+-+ + + +-+-+-+-+ +-+-+-+-+ + +-+-+ + + +-+-+ + +-+ + + + + +-+-+ +-+-+ + + + +-+ +-+-+ +-+-+-+-+
|     | |     | | |   |     | |           | |   | | | | |   | |     |         | |   |     |   |     |
+-+ + + +-+ + + + + +-+ +-+ + + + +-+-+ +-+-+ +-+-+ + + + + + +-+-+-+ + +-+ + + +-+-+-+ +-+ + + +-+-+
|   | | | | | |   |       |   | |   |   | |       | |   | |       |   | |   | | |     | |   | | | | |
+ + +-+-+ +-+ + +-+-+-+-+-+ +-+-+-+-+-+ + + + + +-+ + + +-+-+-+-+-+-+-+ + + + +-+ +-+-+ +-+-+ + + + +
| |                   |     |     |     | | | | | | | |   | |   |       | | |       |   | |         |
+ +-+-+-+-+ + + + + + +-+ +-+ + +-+ +-+-+ + +-+-+ +-+-+-+ + +-+ + + +-+-+-+-+ +-+-+ + +-+ + + +-+ + +
|   |       | | | | | |       | | | |     | |   | |   | |   |   | | |           | | |   |   |   | | |
+-+-+-+ +-+ +-+-+-+ +-+-+-+ +-+-+ + + +-+-+ + + + + + + +-+ + +-+-+-+ +-+ + +-+-+ + +-+ +-+-+ +-+-+-+
| | |   | |       |       |   |         |   | |     | | | | | |       | | |   |     | |             |
+ + + + + +-+ + +-+-+-+-+-+-+-+ +-+ +-+-+-+ +-+ + +-+-+ + +-+ + + +-+-+ +-+-+-+ +-+ + + +-+ +-+-+-+-+
|     |     | |     |   |   |     |   |   |     |     | |   |   |   | | |   |   |   |   | |     | | |
+-+ +-+ +-+-+-+-+-+-+ +-+ + + +-+-+ +-+ + + + +-+-+ + + + +-+ +-+ +-+ + +-+ + +-+-+-+ +-+ + +-+-+ + +
|   |       |           | | |   |     | | | |     | | |     | |       |         |     |   |         |
+-+-+-+-+ + +-+ + +-+ +-+ +-+-+-+-+-+ +-+ + +-+-+-+ + + +-+-+ +-+ +-+ + +-+-+ + +-+ + + +-+-+-+-+ +-+
|       | | | | |   |   |   |   |     |   | |   | | |         |     | | |   | | |   | |           | |
+ +-+ + + + + +-+ +-+ +-+ +-+ +-+ + +-+ +-+-+ + + +-+-+ + +-+-+ + + +-+ +-+ + +-+-+-+ + +-+ + + + + +
| | | | | |   |   |           |   |   | |     |   |     | |   | | |   | |   |     |   |   | | | |   |
+-+ + +-+ + + + +-+-+ +-+-+ +-+-+-+ + + +-+ +-+ + +-+-+ +-+ + +-+-+ +-+ + + +-+-+-+ +-+-+ +-+ + +-+-+
|         | |     |   |         |   |         | | |       | |       |     | |       |       | |     |
+-+-+-+-+-+-+-+-+-+-+-+-+-+-+-+-+-+-+-+-+-+-+-+-+-+-+-+-+-+-+-+-+-+-+-+-+-+-+-+-+-+-+-+-+-+-+-+-+-+-+
