40
40
+-+-+-+-+-+-+-+-+-+-+-+-+-+-+-+-+-+-+-+-+-+-+-+-+-+-+-+-+-+-+-+-+-+-+-+-+-+-+-+-+
|     |   |       | | |     | | |   | |   |   |         | | | |   |   |         |
+-+-+ + + + +-+-+-+ + +-+ +-+ + + +-+ +-+ + +-+-+-+-+ +-+ + + + +-+ +-+-+-+ + + +
|   |   | |   |   |   |       |       | | |   | |     |     |       |   |   | | |
+ + +-+ +-+ +-+ +-+ +-+ + +-+ +-+ +-+-+ + + +-+ + +-+ +-+ + + + +-+ +-+ + +-+-+ +
| | |       | |   | |   | | | | |             |     |   | |   | | |   |       | |
+-+ + +-+ + + + +-+ +-+-+ + +-+ + +-+ +-+-+-+-+-+-+-+ +-+-+-+-+ + +-+-+-+-+ +-+-+
|       | | |         |         | | | | | |     |     |         | |   |   | | | |
+ + +-+-+ + + +-+-+-+ + +-+-+-+ + + +-+ + +-+ + + +-+ + + + +-+-+ + +-+ + + + + +
| |   | | |         |   | |   |       | | | | |     |   | |   |     |   |   |   |
+ +-+-+ +-+-+ +-+-+-+-+-+ +-+ + + + +-+ + + + +-+-+ +-+-+ +-+ +-+ +-+-+-+ +-+ +-+
| | |           |       |       | |   |   | |   |   | |   |     | |         |   |
+-+ + +-+ +-+-+ + +-+-+-+ +-+ +-+ +-+-+-+ + +-+ +-+ + + +-+ +-+ + +-+ +-+ + + +-+
| |   |   |         |     | | |           |   | |     | |   |     |     | |   | |
+ +-+ +-+-+-+ + +-+-+ +-+-+ + +-+-+ + +-+-+ + + +-+ + +-+-+-+ +-+ + + + +-+-+ + +
| |   |     | | |       | |     | | | | | | |     | |       | |     | |   | | | |
+ +-+-+ +-+ + +-+ +-+-+-+ + + +-+ + + + + + +-+ + +-+ + +-+-+-+-+-+-+-+ +-+ +-+ +
|   |     | | |       |     |   |   |   |     | |   | | |   |                 | |
+ +-+ + + +-+-+-+ +-+-+ +-+-+-+ +-+ +-+ +-+ +-+ +-+-+-+-+ + +-+-+-+-+ + +-+ +-+ +
|     | |   | | |     | |   | |   |   |     | |     |   | |   | |     | | |     |
+ + +-+ + +-+ + +-+-+ +-+-+ + +-+ +-+-+ +-+ + + +-+-+ +-+-+ +-+ +-+-+-+ + + +-+ +
| | |   | | |     | |     |       | |   | | |   |   |   |     | |   |     | |   |
+ + +-+-+-+ +-+ +-+ + + +-+-+-+ + + +-+-+ +-+ + + +-+-+ + +-+-+ +-+ +-+ + +-+-+ +
| |     |   |   |   | |   |   | |   |     |   |   |   | |       | |     | |     |
+-+ +-+-+ +-+ + + +-+-+ +-+ + + +-+ +-+ +-+-+-+-+ +-+ + +-+ +-+-+ +-+ +-+ +-+ +-+
| |       | | | | | |     | |   | |       |   |       |     |       | |   | |   |
+ + + +-+ + + +-+ + +-+-+-+-+ + + +-+ +-+ + +-+ + + +-+ +-+ + + + +-+-+-+-+ + + +
| | | | | |         |     |   |   |   |       | | | | | |     | | |     | |   | |
+ + +-+ +-+ +-+-+ + +-+ + + + + +-+-+ + + +-+-+-+-+-+ +-+-+ + +-+-+ +-+ + +-+-+ +
|     |         | | |   | | | |     | | | |     |     |     |   |     |     | | |
+ +-+-+-+-+-+-+ +-+ + +-+ + +-+-+ + +-+-+ +-+ +-+ +-+ +-+ + + + + +-+-+-+ +-+ +-+
|     | |       |   | |   | |   | | | |   |     |   | | | | | |   | |   |   |   |
+ +-+-+ + +-+ +-+-+ +-+-+ +-+ + +-+-+ +-+ + +-+ +-+ + + + +-+-+ +-+ + + +-+-+-+ +
| | |       | |         |     |   |   |     | |   | |       | | | | | |     |   |
+ + +-+ + +-+-+-+ +-+ + +-+ +-+ + + + + +-+-+ +-+ +-+ +-+ +-+ +-+ + +-+ +-+ +-+ +
| |     | |     |   | |       | |   |         |   |     |           | |   |     |
+ + +-+-+-+ +-+ +-+-+ + + + + +-+ + +-+ +-+ +-+ +-+ +-+-+ +-+-+ + +-+ + +-+ + + +
|   | | |   | |     | | | | |   | | |     |   |   |   | |     | | | |     | | | |
+-+ + + + +-+ +-+-+-+-+-+-+ +-+-+-+-+ +-+ +-+ + +-+ + + +-+-+-+-+-+ + +-+-+ +-+-+
|   |   |       | | |   |     |   | |   |   | | |   |       |   |       |     | |
+-+-+-+ +-+-+ + + + + +-+ +-+-+ + + + + +-+ +-+-+ +-+ +-+-+-+-+ + +-+ + +-+-+ + +
|     |   | | |         |   |   |   | | | | |     |     |     | | |   | | |     |
+ +-+ + +-+ +-+ +-+ +-+-+-+-+ +-+ + +-+ + +-+ +-+ +-+ +-+-+ +-+ +-+-+-+ + + +-+ +
| |             |           | |   |       |   |     | |       | |     |   | |   |
+ +-+ +-+ +-+-+-+-+-+ +-+-+ +-+ + +-+-+ +-+-+ +-+-+ +-+ +-+ + + + +-+ +-+-+ +-+ +
|   | |   |   |     | |       | |   |   |       |         | | | | | | |       | |
+ +-+ + +-+ +-+ + +-+-+-+-+ +-+-+-+ +-+-+-+ +-+ +-+-+-+-+ + +-+ + + + + +-+-+ +-+
| | | |     | | |       |       | |     |   |     |     | |         |   |   |   |
+-+ +-+ + +-+ + +-+ + + +-+-+ +-+ + +-+-+ + +-+ +-+-+-+ + +-+ +-+-+ +-+ + +-+ +-+
| |   | | | |   |   | | |     |       |   | | | | | |   | |     |   |     |     |
+ + + + +-+ +-+-+ +-+ +-+ + + +-+ +-+ +-+ +-+ +-+ + +-+ +-+ +-+ + +-+-+-+ + +-+ +
| | | |       |   | |   | | | | |   |     | |             |   | |   |   | | |   |
+ + +-+-+-+ +-+ +-+ + + +-+-+-+ +-+-+ +-+ + +-+-+-+ +-+-+-+-+ +-+ +-+-+ + + +-+ +
|   | |     |     |   | |   | |   |   | | |     |   | |   |   | | |       | | | |
+ +-+ + + +-+ +-+ +-+ +-+-+ + +-+ + +-+ + +-+ + + +-+ + +-+ + + +-+ + +-+ + + +-+
|       | |   | | |         |   |       | |   |   | |     | |   | | | |   |   | |
+-+-+ +-+-+-+ + + + +-+ +-+-+-+ +-+-+-+ + +-+ +-+ + +-+ + + +-+ + +-+-+-+-+-+ + +
|     | | | | |   | | | |     | |   | | | |   | |   | | | | |   | |         |   |
+ +-+ + + + + +-+-+ + +-+-+ +-+ +-+ + +-+ + +-+ + +-+ +-+ +-+-+-+ +-+-+-+ +-+-+ +
| |   | | |     |           | | |     | |   | | |   |   | | |   |   | |       | |
+ +-+-+ + +-+-+-+ + +-+-+ + + + + +-+ + + + + + +-+ + + + + + +-+-+ + + +-+ +-+ +
|                 | |     |       | |     | |         |   |   |   | |   |     | |
+-+ +-+-+ +-+ +-+ + +-+ + +-+-+-+-+ +-+ +-+-+-+ + +-+ + +-+ +-+-+ + + + + +-+ + +
|   |   | |   | | |   | |       |   |         | | | | |   |     | |   | | |   | |
+ + + + + +-+-+ + + + +-+ +-+-+-+-+ +-+ + +-+ +-+-+ + +-+-+ +-+ + + +-+-+-+ + +-+
| |   | |   |   | | | | | |   |         | | |   |   | | | | |   |   |       |   |
+-+ + +-+-+ +-+ +-+ +-+ +-+ +-+-+-+ + +-+-+ + + +-+ + + + +-+-+ + +-+-+ +-+-+ +-+
|   |   |   |     |           | |   |   |     |     |         |   |     | |   | |
+-+-+ +-+-+-+ +-+-+ + +-+-+-+ + + +-+-+-+ + + +-+-+ + +-+ + +-+ +-+-+ +-+ + +-+ +
| |     |   |     | | | | |   |       |   | | |     | |   |   | |   |   |   |   |
+ +-+ +-+-+ + +-+ +-+-+ + +-+ +-+ + +-+-+ +-+-+ +-+-+-+ +-+ + +-+ +-+-+-+-+ + +-+
| |   | |       |   |   |   | | | |   |   | |     |   | | | | |     | |         |
+ +-+ + +-+-+ + + + + +-+ +-+-+ + + +-+ +-+ + + + + +-+-+ +-+-+-+-+ + + + + +-+ +
| |         | | | |     |     | | | |   | |   | |     |   |   |     |   | | |   |
+ +-+-+-+-+ + +-+-+-+ +-+-+ + + +-+ +-+ + +-+ +-+ +-+-+-+ + + + +-+ + + +-+ +-+-+
|       |     |     |   |   | |   | | | |     | |       |   |   |     | |     | |
+-+ +-+-+ +-+ +-+ + + +-+-+ + + +-+ + + + +-+-+ + + + + + +-+-+ +-+ + +-+-+-+-+ +
|     |     | |   |   |   | |     |   | |   |     | | |       |   | |           |
+ +-+ + +-+-+ +-+ +-+-+ + + +-+ + +-+-+ + +-+ +-+ + + +-+-+-+-+-+-+-+ +-+ + + +-+
| |       |     | |     |   |   |       |   |   | | |     |             | | |   |
+-+-+-+-+-+-+-+-+-+-+-+-+-+-+-+-+-+-+-+-+-+-+-+-+-+-+-+-+-+-+-+-+-+-+-+-+-+-+-+-+
