5
5
+-+-+-+-+-+
| |       |
+ +-+ +-+-+
|         |
+-+-+ +-+-+
|       | |
+ + +-+-+ +
| | |   | |
+-+ +-+ + +
|         |
+-+-+-+-+-+
