10
10
+-+-+-+-+-+-+-+-+-+-+
| |   |     | |     |
+ + +-+-+ +-+ + +-+-+
| |   |             |
+ + +-+ +-+ + +-+ + +
|     | |   | | | | |
+ +-+-+ + +-+ + +-+-+
|   |   |   |       |
+ +-+-+ +-+-+-+ +-+ +
| |   |       |   | |
+ +-+ +-+-+ +-+-+-+-+
|   | | | | | |     |
+ + + + + + + + +-+ +
| |           |   | |
+-+ +-+-+ +-+-+ +-+-+
| |   | |           |
+ + +-+ + +-+-+ + + +
| |   |   |     | | |
+ + +-+ +-+-+ +-+-+ +
|   |     |       | |
+-+-+-+-+-+-+-+-+-+-+
