20
20
+-+-+-+-+-+-+-+-+-+-+-+-+-+-+-+-+-+-+-+-+
|   | |   | |       |             |     |
+-+ + +-+ + + + + +-+ +-+-+-+-+-+-+ + +-+
|   |       | | | |   |     |   |   | | |
+-+ +-+ + +-+-+-+ + +-+-+ +-+ +-+-+-+ + +
|   | | |   |   |   |         | | | |   |
+ +-+ + + +-+ + +-+ +-+ + + +-+ + + +-+ +
|       | |   |     |   | | |     |     |
+ +-+-+ + + +-+ + +-+ +-+-+ +-+ + +-+ +-+
|     | |     | | |     |       |     | |
+-+ +-+-+ +-+-+-+ +-+-+ +-+-+ +-+-+ +-+ +
|   | | |   |     | |     |     |     | |
+-+ + + +-+-+ +-+ + + +-+-+-+ + +-+-+-+ +
|     |       |   |     | |   |         |
+ +-+-+ +-+-+-+-+ +-+-+ + + +-+ + +-+ +-+
| |         |   |         | | | | |     |
+-+-+-+-+-+-+-+ +-+-+-+-+ + + +-+ +-+ + +
|   | |           |   |   | |   |   | | |
+ + + + + + +-+ +-+ +-+-+ + + +-+ +-+-+ +
| |     | | |     |   |   |   |     | | |
+-+ +-+-+ +-+ + + +-+ + +-+ + +-+ +-+ +-+
|   | |   |   | | |   | | | |   |       |
+ + + +-+-+ +-+-+ +-+ + + +-+ +-+ +-+ + +
| | |         |     |   | |   | |   | | |
+ +-+-+-+ +-+ +-+-+ + + + +-+-+ +-+ + +-+
|     |   |     |     |   |     | | |   |
+ + +-+ + +-+ +-+-+-+ +-+-+ +-+ + +-+ +-+
| | |   | |   |   |       | |           |
+ +-+-+-+-+-+-+ + +-+-+-+ +-+-+ + + +-+ +
|     |       | |   |       | | | | |   |
+-+-+-+-+ +-+-+ + + +-+ +-+ + + +-+ + +-+
|           | | | |   | | |   | |   |   |
+-+ +-+ +-+-+ + + +-+ + + +-+-+-+-+-+-+ +
| | |       |   |   |         |     |   |
+ +-+ + + +-+ +-+-+-+ + + +-+ + +-+ + +-+
|     | |       |   | | |   | | |       |
+-+ + +-+-+-+-+ + +-+ + +-+-+-+ +-+-+-+-+
|   |         |   | | |       |   |     |
+-+-+ +-+-+ +-+-+-+ +-+ +-+-+-+ + + + + +
|       |   |           |       |   | | |
+-+-+-+-+-+-+-+-+-+-+-+-+-+-+-+-+-+-+-+-+
