10
10
+-+-+-+-+-+-+-+-+-+-+
|       | |         |
+-+ +-+-+ + + +-+-+-+
|   |       |   |   |
+ +-+-+ + +-+ + + +-+
|       | |   |   | |
+ +-+ + +-+ + + +-+ +
| | | | | | | |   | |
+ + +-+ + +-+-+ +-+ +
|   |         |     |
+ +-+-+-+ + +-+-+-+-+
|     | | |         |
+ +-+ + +-+-+-+ + +-+
| |       | |   |   |
+-+-+ +-+-+ + +-+ + +
|     | |     | | | |
+ +-+-+ + +-+ + +-+-+
| |     |   |   | | |
+ + +-+ +-+ +-+-+ + +
|   |   |           |
+-+-+-+-+-+-+-+-+-+-+
