5
5
+-+-+-+-+-+
|     | | |
+ + + + + +
| | |     |
+-+-+-+ + +
|     | | |
+-+-+ + +-+
|     |   |
+ + +-+ + +
| |     | |
+-+-+-+-+-+
