15
12
+-+-+-+-+-+-+-+-+-+-+-+-+-+-+-+
|   |                 |       |
+-+ +-+ +-+-+-+-+-+ +-+ + +-+ +
|     | |   | |   | |   |   | |
+-+ + +-+ +-+ +-+ + +-+-+ + +-+
|   |   |     |       |   |   |
+ +-+ +-+-+-+ + +-+-+ +-+-+ + +
| |               |     |   | |
+ +-+ +-+ +-+-+-+ +-+-+-+ +-+-+
|   | |     |         |     | |
+ + +-+-+ +-+ +-+-+-+ +-+-+ + +
| | |     | | |   |   |     | |
+ + + +-+ + +-+-+ +-+ +-+ + + +
| | |   |   |   |         |   |
+-+-+-+-+ +-+ +-+ + + +-+ +-+-+
| |   |       | | | | | |   | |
+ +-+ + +-+-+ + + + +-+ +-+-+ +
|   |     |   |   |   |       |
+ + +-+-+ + +-+-+ +-+-+-+ +-+-+
| |       |   |               |
+ +-+ +-+ + + +-+-+-+-+ +-+-+ +
| | | | | | | |   |   |     | |
+ + + + + + + + + +-+ + + +-+-+
| |   |   | | | |       |     |
+-+-+-+-+-+-+-+-+-+-+-+-+-+-+-+
