40
40
+-+-+-+-+-+-+-+-+-+-+-+-+-+-+-+-+-+-+-+-+-+-+-+-+-+-+-+-+-+-+-+-+-+-+-+-+-+-+-+-+
| |   |       |     | | |   |   |     |       | | |   |   |   |   |     |     | |
+ + +-+ + +-+-+-+ + + + +-+ +-+ + +-+-+ +-+-+-+ + + +-+-+ + +-+ +-+-+ + + + +-+ +
|     | |     |   | | |     | |   |               | |                 | | |     |
+ +-+-+-+ +-+ + +-+-+ +-+ +-+ + +-+-+ + +-+-+ + +-+ +-+-+ + +-+ +-+-+-+ +-+-+-+ +
|   |       | |   | |             | | |     | | | | | |   | |   |     |   |     |
+ + +-+ +-+-+-+ +-+ + + + + +-+-+-+ + + +-+ +-+-+ + + +-+-+-+ +-+-+-+ +-+ +-+ + +
| |     |   | |       | | | |     | | | | |   |       |   |   |       |       | |
+ + +-+ + + + +-+-+-+-+ +-+ + +-+-+ +-+ + +-+-+ + +-+-+ +-+ + +-+-+ +-+ +-+ + + +
| |   |   | |     |     | | | | |         | | | |   |   |   |       |     | | | |
+-+-+ + + +-+-+ + +-+ + + + + + + +-+-+-+-+ + + +-+-+-+ +-+-+-+-+ +-+ +-+-+-+ +-+
| |   | | |   | |   | |   |         |         |       | |   | | |   | |         |
+ + + +-+-+-+ + + +-+ + + + + +-+-+ + + +-+-+ +-+-+-+ + +-+ + + + + +-+-+ +-+ +-+
|   |     | | | |     | | | |   |     | | |   | |   | | |       | |     | | | | |
+ +-+ + +-+ + +-+-+ +-+-+-+-+ +-+-+-+-+ + + + + +-+ + + +-+ +-+-+-+-+-+ +-+ + + +
| |   |       |           |     |   |   | | |     |                   | |   |   |
+-+-+ +-+ + +-+-+ + +-+-+-+ +-+-+ +-+-+ + +-+-+ +-+-+-+ +-+-+-+ + + +-+ + + +-+ +
|     |   | |     | |     |       |     |   |   |     |   |     | |   |   | | | |
+-+ +-+ +-+ + +-+-+-+-+ + + +-+-+-+ + +-+-+ + +-+-+-+ + +-+ + +-+-+-+-+-+ +-+ +-+
|   |   | |         |   |     | |   |   |   | | |   |     | | |       | | |     |
+-+ +-+-+ + +-+-+ +-+-+ +-+-+-+ + + +-+-+-+ +-+ + + + +-+ +-+ +-+-+ +-+ + +-+ +-+
|   |       |       |   | |     | |         |     | |   |   | |         |       |
+ +-+-+ +-+-+-+ + +-+ +-+ +-+ +-+-+ +-+-+-+ +-+ +-+-+-+-+ + +-+-+ + +-+ +-+-+ + +
| | |     |     | |   | |   |             |     | | |     | | |   | |         | |
+-+ +-+ + +-+ +-+ +-+-+ + +-+-+-+ + +-+-+-+-+-+ + + +-+ +-+ + + +-+-+ +-+ +-+ +-+
|       | | | |   |     |   | | | | |           |     |   |   |   | | | |   |   |
+-+ + + + + +-+-+-+ + + + +-+ + +-+-+-+-+-+-+-+ + + + +-+-+-+ +-+-+ +-+ +-+-+ + +
|   | | |     |   | | |     |   | |     | |       | | |       |       |   |   | |
+ +-+ +-+-+ +-+ +-+-+ +-+-+-+ +-+ + + + + + +-+ +-+ +-+ +-+-+ +-+ +-+ + + +-+ + +
| | | |     |     | |     |       | | | |   |     |   | |       | |     |     | |
+-+ +-+-+ + +-+ +-+ + +-+ +-+ +-+ +-+ +-+ + +-+-+ +-+-+ +-+-+ +-+-+-+ + +-+ +-+ +
|     |   | | | |   |   | | |   |   | | | |   |     |     | | |       | |     | |
+-+ + +-+-+ + + + + +-+ +-+ + +-+ +-+ + +-+ +-+-+ +-+-+-+ + +-+ +-+ +-+ +-+-+-+ +
| | |         |   |     |       |   |   |       |   |         |   | |       |   |
+ + +-+ +-+-+ +-+ +-+-+ + +-+ + +-+-+ + +-+-+ +-+-+ + + + +-+ + + +-+-+ +-+-+ +-+
|   |     | |     | |       | | | |   |   |   |       | | |   | |   |     | | | |
+-+-+-+-+-+ +-+ +-+ +-+ +-+ + +-+ +-+-+-+ + + +-+ + +-+ + +-+-+-+-+-+-+-+ + +-+ +
| |         |       |     | |   |         | | |   | |   | |     |   |         | |
+ + +-+ + +-+-+ +-+-+ +-+ +-+-+ +-+-+ +-+ +-+-+-+ + + +-+-+-+ + + + +-+ + + + + +
|     | |       | |   |   |   |   |     |   |     | | |     | | | | |   | | |   |
+-+-+-+ +-+ +-+-+ + +-+-+-+-+ + +-+-+ + +-+-+-+-+-+ +-+-+-+ +-+ +-+ +-+ +-+-+-+ +
|     | |   | |   |   |   | |   |   | |     |     | | |   |       | |     | |   |
+-+ +-+-+-+ + +-+ + + +-+ + + + +-+ + + + +-+-+ +-+-+ + +-+-+ +-+ + + +-+ + +-+ +
|         | |     | | |       | |     | |       |   |       | | |       |   |   |
+-+-+-+-+ + + +-+-+-+ +-+-+-+-+ + +-+-+ +-+ +-+ +-+ +-+ +-+ + + +-+-+ +-+-+-+-+ +
| | |         | |     |     |   | |   |   |   |   |     | |       |   |     |   |
+ + + +-+-+-+ + +-+ +-+-+-+ + +-+-+ +-+-+-+ +-+ +-+ +-+-+ + + +-+-+-+ +-+-+ + + +
|       | |     |     |     | |       |       |   | | | |   |       | |       | |
+ +-+-+ + +-+ + +-+-+-+-+ +-+ + + + +-+ + + + +-+-+-+ + +-+ +-+ + +-+-+ + + + + +
|   |   |   | |     |   | | |   | | | | | | | | | |   |   | |   |   |   | | | | |
+ +-+-+-+ +-+ +-+ +-+-+ + + +-+ +-+-+ + +-+-+-+ + + + + + +-+ + + +-+-+-+ +-+-+ +
|   |   |   | | |   |             | |       |   |   |   |     | | |         |   |
+-+-+-+ +-+ + + +-+-+-+-+-+ +-+-+ + +-+-+ +-+ +-+ +-+-+ + + +-+-+-+-+ + +-+ + +-+
|     | |     |         | | |         |     |     |   | | | |       | |   | |   |
+ + +-+ +-+ + + + + +-+-+ +-+-+-+ +-+ + + +-+ +-+ + +-+ +-+-+-+-+-+ +-+-+-+ +-+ +
| |     |   |   | | |   | |   | | |     |     |   | | |     | |     |   | |   | |
+-+ +-+ +-+-+-+-+-+ +-+ + + +-+ +-+ +-+-+ +-+-+-+-+ + +-+ + + +-+ +-+ +-+ +-+-+-+
|     | |         |         |         |       |   |       |     |   |         | |
+-+ +-+-+-+-+ +-+-+-+ +-+ + + +-+-+ +-+-+-+-+ + +-+ +-+ + + + +-+ +-+-+ +-+-+ + +
|         | |           | | | |       |         | | |   | | |               | | |
+ +-+-+-+ + + +-+-+-+ + + +-+-+-+-+ +-+ +-+-+ +-+ +-+ +-+ + + +-+-+-+-+-+-+-+-+ +
| | |     |         | | | |       |   |     | | |   | |   | |     | | |         |
+ + +-+ +-+-+ +-+-+ + +-+-+-+-+ +-+-+ + +-+-+ + +-+ + +-+-+-+-+ +-+ + + +-+ +-+ +
| |         | | | | |   | |   |   |   | |   |   |   |         |   |   | | |   | |
+ + +-+-+-+-+ + + +-+-+-+ + +-+ + + +-+-+-+ + +-+ + +-+ +-+-+ + +-+ +-+-+ + + + +
| |   |       |   |   | |     | |     | | | |   | |   |     | |   |         | | |
+-+-+ +-+ +-+-+ +-+-+ + + +-+ + +-+ +-+ + + +-+-+ + +-+-+ + +-+ +-+ +-+-+ +-+-+-+
|   |       | |     |   | |       |   | | | | | | |       |   |     | |       | |
+-+ +-+ +-+ + +-+-+ + +-+ + +-+-+ +-+ + + + + + + +-+-+ +-+ +-+-+-+ + + + +-+-+ +
|   |     |     |         |     | |         |   | | | | | | |     |   | |   |   |
+-+ + +-+ +-+ +-+-+ + +-+ + +-+-+-+ +-+ +-+-+-+ + + + + + + + +-+-+-+ +-+ +-+ + +
|     |     | |     | |   |     |   |         |       |   |   |     | |     | | |
+ +-+ + + +-+-+-+-+ + + +-+-+ +-+-+-+ + + +-+ +-+-+-+-+ +-+-+ +-+-+ +-+ +-+ + + +
| |   | |       |   | |   |     |   | | | |         |       | |     | | |     | |
+ +-+-+-+-+-+-+-+ +-+-+ +-+-+-+ + + +-+-+ +-+ + +-+ + +-+ +-+-+ +-+-+ + +-+ +-+ +
| |       |   |     |       | | | | |       | | |   | |           |   |   | | | |
+-+ +-+ +-+-+ + + +-+ + +-+ + + + + + +-+-+ +-+ +-+-+ +-+-+ +-+-+-+ + + +-+-+ + +
| | | |   |     | | | | | | | | | |   |       | |     | |         | |   |       |
+ + + + + + + +-+-+ +-+ + + + +-+-+-+ + +-+-+-+-+ + + + + + +-+-+ +-+ +-+ +-+-+ +
|   |   |   |       |   |       |     |       |   | | |   | |     |   |       | |
+-+-+-+-+-+-+-+-+-+-+-+-+-+-+-+-+-+-+-+-+-+-+-+-+-+-+-+-+-+-+-+-+-+-+-+-+-+-+-+-+
