10
10
+-+-+-+-+-+-+-+-+-+-+
|   |     |     |   |
+-+ + +-+-+ + + +-+ +
| |   |     | | |   |
+ +-+ + +-+ +-+ +-+ +
| |   |   |   | |   |
+ + + + +-+-+ +-+ +-+
|   |   |           |
+-+-+ +-+-+ +-+ +-+-+
|     | | |   | |   |
+ + +-+ + +-+ +-+ +-+
| | |               |
+ +-+-+-+ +-+-+ +-+-+
| | |       |       |
+-+ +-+-+-+-+ +-+ +-+
|       |       |   |
+-+-+ +-+ + +-+-+ +-+
| |       | |   |   |
+ +-+ + +-+ + +-+ +-+
|     |   | |       |
+-+-+-+-+-+-+-+-+-+-+
