30
30
+-+-+-+-+-+-+-+-+-+-+-+-+-+-+-+-+-+-+-+-+-+-+-+-+-+-+-+-+-+-+
|   |   |           |     | | |   | |     |       | |       |
+ +-+ +-+-+-+-+ +-+ +-+ + + + +-+ + + + +-+ + +-+ + +-+ + +-+
|               |   |   |   |   |     |     | |       | |   |
+-+-+-+-+ +-+-+ + +-+-+ +-+-+ + +-+-+ +-+ + +-+ +-+-+ +-+ +-+
|         |     |         |   |       |   | |   | | |     | |
+-+-+ + +-+-+-+ +-+ + + + + +-+ +-+-+ +-+-+-+ + + + + + + + +
| |   |       |   | | | | | |     | | |   |   | |   | | |   |
+ +-+-+ + +-+-+-+-+ +-+-+ +-+-+-+-+ + + +-+-+ +-+ + +-+-+-+-+
|     | |     |   |     | | | | | |     | |   | | |       | |
+ +-+ +-+-+-+-+-+ + +-+-+-+ + + + +-+ +-+ +-+-+ +-+ +-+-+ + +
| |       |       |   |   |   |   |   |     |         |   | |
+ +-+ +-+-+ + +-+ + + + +-+-+ + +-+ +-+ +-+ +-+ +-+ +-+ +-+ +
| |     | | | |     |     |         |     |       | | | | | |
+-+ +-+-+ +-+-+ +-+ +-+-+ + +-+-+ + + +-+ + + +-+ +-+ +-+ + +
|     | |     | | |     |     |   | | |   | |   |   | |     |
+ + + + + +-+ + + +-+-+-+-+-+-+-+ +-+-+-+-+-+ + +-+ + +-+ + +
| | |   | | |           |         |   |   | | | |   |   | | |
+-+ +-+ +-+ +-+-+ +-+ +-+ +-+ +-+ + + + +-+ + + + +-+-+ + +-+
|   |   |   | |     | |   |   | | | |   |     | | |         |
+-+-+-+ + + + + +-+ +-+-+ +-+ + +-+ +-+-+-+ +-+ +-+-+ + +-+-+
|   | |   | |   | |   | |   |           |   |     |   | |   |
+ + + + + +-+-+-+ +-+-+ + +-+-+-+ + + + + +-+-+-+ + + +-+-+ +
| |   | |       |         |     | | | | |     | | | | | |   |
+-+ +-+-+ + + + +-+ + +-+-+-+ +-+ +-+-+-+-+-+ + +-+ +-+ + +-+
|         | | |     |         | | |     |         |         |
+-+-+-+ + +-+-+ +-+-+-+ +-+ + + +-+-+ +-+ +-+-+-+-+-+ +-+ +-+
|   |   | |   |       |   | |   |   |   |     | | |   |     |
+ +-+ +-+-+ +-+ + +-+-+-+-+-+-+-+ + + +-+ + + + + + +-+-+-+ +
|       | | |   | |   |   |   |   | |     | | |     |   |   |
+ +-+ + + + + +-+ + + + + + + +-+-+ +-+-+-+-+ +-+ + + +-+ +-+
| |   | |   | | |   |   | | | |   | | | |   |     | | |   | |
+ + +-+ + +-+-+ + +-+ +-+-+ +-+-+ + + + +-+ +-+ +-+ + + +-+ +
| | | | |     |     |         |   |       | |     |   |   | |
+-+ + + +-+ +-+-+ +-+ + + +-+ + +-+ +-+-+-+ +-+ +-+-+ +-+-+ +
| | |   |   | |   | | | |   |                   | |         |
+ + + + + +-+ + + + +-+-+-+ +-+ +-+-+ + +-+ + +-+ + +-+ +-+-+
|   | | | | | | |   | |   | |   |     | | | | |   | |       |
+-+ +-+-+ + + + + +-+ + +-+-+ +-+-+-+ + + + + +-+ + +-+-+-+ +
|       |     | | |     | |       |   | |   | |     |       |
+ +-+ +-+-+ + +-+ +-+-+ + +-+-+ +-+-+ +-+-+-+-+-+ +-+ +-+ +-+
| | | |   | |       |           |         | | | | | | | |   |
+ + +-+ + + +-+-+-+-+-+-+-+-+ + +-+-+ +-+ + + + +-+ +-+ + +-+
|     | |   |         |   | | | |     |     | | |     |     |
+ +-+-+ + + +-+ + +-+-+ + + + +-+-+-+-+-+-+ + + + +-+ + +-+-+
| |     | |   | |     | | |     |   | |   |         | |     |
+-+ + +-+-+-+-+-+-+ + + +-+-+ +-+ +-+ + +-+-+ +-+-+-+-+ +-+ +
|   |   | |   | |   | |   |   |             |   |     | |   |
+ + + +-+ + +-+ +-+-+ +-+ +-+ +-+-+ +-+-+ +-+-+-+-+ +-+ + +-+
| | | |             |       |       |   | |       | |   | | |
+-+-+ + + +-+-+ +-+-+-+ +-+-+ +-+-+ +-+ +-+-+ +-+ + +-+-+-+ +
|   | | | |     |   |         | |             |   | |     | |
+ + + +-+ +-+ + +-+ + + + +-+-+ +-+-+ +-+-+-+ +-+-+ + +-+ + +
| |   |   |   |       | |     | |   |   |   |     |   |   | |
+ +-+-+-+ + + +-+-+ +-+ +-+-+ + + +-+-+ + + + + + + +-+ + + +
|   | | | | |   | | |   |     |     |   | |   | |     | | | |
+ + + + + +-+ + + +-+ +-+ +-+ + +-+ + +-+ + +-+-+-+-+-+ +-+ +
| |   |   |   |   | |   | |     |   |   | | |     |         |
+ +-+-+-+ +-+ + +-+ +-+ +-+-+-+ +-+ +-+ +-+-+-+ +-+ +-+-+-+-+
|     |   |   |       |   |       |   |         |           |
+-+-+-+-+-+-+-+-+-+-+-+-+-+-+-+-+-+-+-+-+-+-+-+-+-+-+-+-+-+-+
