15
12
+-+-+-+-+-+-+-+-+-+-+-+-+-+-+-+
|   | |   |   |   |       | | |
+-+ + +-+ + +-+-+ +-+ +-+-+ + +
|     | |   |   |   |         |
+-+ + + + + + +-+ + + +-+-+-+ +
| | |     | |   | |   |     | |
+ +-+ +-+-+ +-+ +-+ +-+-+-+ + +
|     |   | |         |       |
+ + +-+ + +-+ +-+ + + +-+ +-+-+
| |     | |     | | |   |     |
+ +-+-+-+-+-+ +-+ + + +-+ +-+-+
| |       | | |   | | | | | | |
+ + + +-+ + +-+-+-+-+ + +-+ + +
| | |   |       |       |     |
+ +-+-+ +-+ + + + +-+-+ +-+ +-+
| |   | | | | | |     |   | | |
+ +-+ + + +-+ +-+ +-+ +-+-+ + +
|       | |   | | | | | |     |
+ + + + + +-+ + + + +-+ +-+ +-+
| | | | |   | |       |       |
+-+ + + + +-+-+ + +-+-+ +-+-+ +
|   | | |       |         |   |
+ +-+ +-+ + +-+-+-+ + + + + +-+
| |       | |       | | | |   |
+-+-+-+-+-+-+-+-+-+-+-+-+-+-+-+
