20
20
+-+-+-+-+-+-+-+-+-+-+-+-+-+-+-+-+-+-+-+-+
|         |   |   |     | |       | | | |
+ + + +-+-+ + + +-+-+-+ + + +-+-+-+ + + +
| | |       |   | | | | |           |   |
+ + +-+-+ +-+ +-+ + + + + +-+-+ +-+ +-+ +
| |   |   | | |               | | | |   |
+-+ +-+ + + +-+-+-+ + +-+-+-+-+ + + + + +
| | | | |   |     | |   |     | |     | |
+ + + + +-+ +-+-+ +-+-+-+ +-+ + +-+-+-+ +
|   |   |     |       | | |       |     |
+ + +-+ +-+ + +-+-+ + + +-+ +-+-+-+-+ + +
| | | | |   |       | |   |   |     | | |
+-+-+ +-+-+-+-+-+ + +-+-+ +-+-+ +-+ + +-+
| |           |   |   | |   |     | |   |
+ + +-+ +-+ +-+ +-+ +-+ + +-+-+ +-+ + +-+
|     | |   |   |     |         |   |   |
+-+-+-+-+ +-+ +-+-+-+ +-+-+-+-+-+-+ +-+ +
|       | |   |           |   |         |
+-+ +-+-+ +-+ + +-+-+-+-+ + +-+ +-+-+-+-+
| | |   | | | | |       |       |   |   |
+ + + + + + +-+-+-+-+-+ + +-+ +-+ +-+ + +
| |   |   |     | |       |   |   |   | |
+ + +-+ + + +-+-+ + +-+-+ +-+ + +-+ +-+ +
|     | |     | |   |   | |   |       | |
+-+-+ +-+-+-+ + +-+ + + + +-+ + +-+-+-+-+
|   | |     |   | | | |   |   | |     | |
+ + +-+-+ +-+-+ + + +-+ +-+-+ + + + +-+ +
| | |   |   |       |   | | |     | | | |
+ +-+ +-+ +-+-+-+ + +-+-+ + +-+-+ +-+ + +
|           |   | | |       |     | |   |
+-+-+-+ +-+ +-+ +-+ + +-+ +-+ +-+ + + +-+
| |     |   |         |   |   |     |   |
+ + +-+ +-+-+ + +-+-+-+-+ +-+-+-+ + + + +
|   |       | | | | | |   | | |   |   | |
+ +-+ +-+ + +-+ + + + +-+ + + + + + +-+ +
|   | |   |       |   |   |   | | | | | |
+ +-+ + + +-+ +-+-+-+ +-+ + + +-+ + + + +
| |   | |   | |         |   | | | |   | |
+ + +-+ +-+ +-+-+ + + + + + +-+ + + +-+ +
| | |   |   |     | | |   |     | | |   |
+-+-+-+-+-+-+-+-+-+-+-+-+-+-+-+-+-+-+-+-+
