20
20
+-+-+-+-+-+-+-+-+-+-+-+-+-+-+-+-+-+-+-+-+
| |   | |     | |     |   |   | |       |
+ + +-+ + +-+-+ + +-+-+-+ + +-+ + + + +-+
| |   |           |   | |   | |   | | | |
+ +-+ + +-+-+ +-+-+ +-+ +-+ + + + + +-+ +
| | |   | |   |           |     | |   | |
+ + +-+-+ +-+ + +-+ +-+ +-+-+ + +-+-+-+ +
|       |   |   | |   | |   | |   |     |
+-+ +-+-+-+ +-+ + +-+-+ + +-+ +-+-+ + +-+
|     | |     |     |     | | |   | |   |
+-+ + + + +-+-+ + +-+-+-+ + + + + + + +-+
| | |       | | | | |         | | | | | |
+ + +-+-+ + + +-+-+ +-+-+ + + + +-+ +-+ +
|   | |   |   |       |   | |         | |
+-+ + +-+ +-+-+-+ +-+-+-+-+-+ +-+ +-+-+ +
|     | |     |     |       | | |       |
+-+ +-+ +-+ +-+ +-+-+-+-+ +-+-+ +-+ +-+-+
| |   |       |                 |   |   |
+ + +-+-+-+ +-+ + +-+-+ +-+-+-+ + + + +-+
|       |     | |   |   | |       |     |
+-+ + +-+-+-+ +-+-+-+-+-+ +-+-+-+-+-+-+ +
|   | |     |         | |               |
+ +-+-+ +-+-+-+-+-+ +-+ + +-+ + +-+-+ +-+
|     |   | | |     |   | |   |   | | | |
+-+ + + + + + +-+-+-+-+ + + +-+-+ + + + +
|   |   | |         |     | |       |   |
+-+-+ +-+-+-+-+-+ +-+ +-+ +-+-+-+ + + +-+
|       |   | | |     | |   |     | |   |
+-+ + + + +-+ + +-+ + + + + + +-+ +-+-+-+
|   | |   | |   |   | |   | |   |   |   |
+-+-+ +-+ + + + + +-+-+-+ +-+-+-+-+ +-+ +
|       | |   |   | |   |     |     |   |
+ +-+-+ +-+ + +-+-+ + +-+-+ +-+-+-+ +-+ +
|     |     | |   | | |       |     |   |
+ + +-+-+-+-+-+-+ + + + +-+-+-+-+-+ + +-+
| | |     | |   |         | |     |   | |
+ +-+ + +-+ + +-+-+ + +-+ + + +-+ + + + +
|     |   | | | |   | |     | |     |   |
+ + +-+ +-+ + + + +-+-+ + +-+ + +-+-+-+ +
| | |           |     | |   | |   |     |
+-+-+-+-+-+-+-+-+-+-+-+-+-+-+-+-+-+-+-+-+
