40
40
+-+-+-+-+-+-+-+-+-+-+-+-+-+-+-+-+-+-+-+-+-+-+-+-+-+-+-+-+-+-+-+-+-+-+-+-+-+-+-+-+
| | | | |     | |   |   |     | |         |     |     | | |     |         | |   |
+ + + + + +-+ + +-+ + +-+-+ + + +-+ +-+ + + +-+-+ + +-+ + + +-+-+ +-+ +-+-+ + +-+
|       | |             |   | |   | |   |         | |   |       | |   |   |     |
+ +-+-+ +-+ + + + +-+-+-+ +-+ +-+ +-+ +-+ +-+ + +-+ + +-+-+ +-+-+-+-+ + +-+ +-+-+
| |         | | | |     | | | | |     |   |   | | |         | |     |       |   |
+-+-+ +-+-+-+-+ +-+-+-+ + + +-+ +-+-+ +-+-+ +-+ + +-+ +-+-+ + +-+-+ + +-+-+ + + +
| | |     |   |     | |   |   |           |   |   | | | |   | |     |     | | | |
+ + + + + + + +-+-+ + +-+ + + + + +-+-+ +-+-+ + +-+ +-+ +-+ + +-+ + + + + +-+ +-+
| |   | |   | |     |       |   |     |     | | |   |     |       |   | |       |
+ + +-+ + +-+-+-+-+ +-+-+-+ +-+ +-+ +-+-+-+-+-+-+ + +-+-+ + +-+ + + +-+ +-+-+-+-+
|     | |   |   |       | | | | |           |     | |   |     | | |   |   | |   |
+-+ +-+-+-+ + + +-+ + +-+ + + +-+-+-+-+ + +-+-+ + +-+-+ +-+-+-+ +-+-+-+-+ + + +-+
|         | | |     | |       |     |   | |     | | |   |   |   |   |       | | |
+-+-+-+-+-+ + +-+-+ +-+-+-+-+ + + +-+-+ +-+ + +-+-+ + +-+ +-+-+ +-+ +-+ +-+ + + +
| |   | |   |     |   |       | |       |   | |   |   |       | | | |     | | | |
+ + +-+ +-+-+-+-+ + + + +-+ + + + +-+ +-+ + +-+ + + +-+-+ +-+ + + + +-+-+ + + + +
| |     |   | | | | | | | | | | | | |     |     |     |   |           |   | | | |
+ + +-+ + + + + +-+ + + + +-+ + +-+ + + +-+-+ + +-+ +-+ + +-+-+-+ +-+-+ +-+-+ + +
|   | |   | |       |     |   | | | | | |   | |   |   | |   |     | |   |       |
+-+-+ + + +-+-+-+-+-+ +-+ + +-+-+ + + + + +-+ + + +-+ +-+ +-+-+-+-+ +-+-+-+ + + +
|   | | |           | |   | |         |   |   | | |     | | | |         |   | | |
+ +-+ +-+ + + +-+-+ + +-+-+ + +-+-+-+-+ +-+-+-+ + +-+-+ +-+ + +-+-+-+ +-+-+-+ +-+
|     |   | |     |   | | | | |           |     | | | |       | | | |     |     |
+-+ + + +-+-+ +-+-+ +-+ + +-+ +-+-+-+ +-+-+ +-+-+ + + +-+ + +-+ + + +-+-+ +-+ + +
|   |   |         |         | | | | |   |   |   | |       |           |     | | |
+-+ + + +-+-+ +-+-+-+-+-+-+-+-+ + + + +-+ + + + + +-+ +-+-+-+-+ +-+ + + +-+ + +-+
| | | | | |   |   | |     |         | | | | | |   | |   |     | | | |   |       |
+ + +-+ + +-+-+ + + +-+ + + +-+ +-+ + + +-+-+-+ +-+ + +-+ +-+-+-+ + + +-+-+-+ +-+
|   |     |     | |   | | | | |   |     | | | |     |   | |   |     | |   |   | |
+ +-+-+ +-+-+-+ + +-+ +-+ + + + + + +-+-+ + + +-+ + + +-+ + +-+-+-+-+-+ + +-+ + +
| |   |   |     | |   |   | | | | |   |     |   | | |     |   | | | |   |       |
+-+-+ + +-+ +-+-+-+ +-+-+ +-+ +-+-+-+-+-+ + +-+ +-+-+-+-+ + +-+ + + +-+-+ + + + +
|         |       | |       | |         | | |   |   | | | |         | | | | | | |
+ +-+-+ + + + +-+ + +-+ +-+ + +-+-+ +-+ + + +-+ + +-+ + + +-+ +-+ + + + + +-+ + +
| |   | | | |   |   | |   | | |     |   | |   |                 | | |   |   | | |
+ + +-+ +-+ + +-+ +-+ +-+ + + +-+-+-+ +-+-+-+ + +-+ +-+ + +-+-+-+-+-+-+ +-+-+-+-+
|   |     | |   |         | |           | |     | | | | | | | |           |     |
+-+-+ +-+-+-+-+-+ +-+ +-+ +-+-+-+-+-+ +-+ + + + + +-+ + +-+ + + + + +-+-+ +-+ + +
|   |       |   |   |   |       |       |   | | | |   |     |   | | |   | |   | |
+ + + +-+-+-+-+ + + + +-+ +-+-+-+-+ + +-+ +-+ +-+ +-+ +-+-+ + + +-+-+ +-+-+-+-+ +
| |   |     |   | | |   |   |   |   | |   | |   |     | | |   |       | |       |
+-+-+-+ + + + +-+-+ + + +-+-+ + + + + +-+-+ + +-+-+ + + + + + + +-+ +-+ + +-+-+-+
|     | | | | |     | | | |   |   | |   |     | |   |   |   | | |       |       |
+ + +-+-+ + + +-+ +-+-+ + +-+ +-+-+-+-+ + +-+ + + +-+-+-+ +-+ +-+-+-+ + +-+ +-+-+
| |   |   |           | |     | |           |     | |     | | | |     | |   |   |
+-+ +-+-+-+ +-+-+-+ +-+ + +-+ + +-+ + + +-+-+ + +-+ +-+-+ + +-+ +-+ + + +-+ + +-+
|       |       |     | | | |   | | | |   | | | |           | |   | | | |     | |
+ +-+ + + + + +-+-+ + +-+ + +-+ + +-+ +-+ + +-+-+-+-+ + + + + +-+ + +-+ + +-+ + +
|   | |   | |   |   |   | |     | |   | | |         | | | |     |     | |   |   |
+ +-+ + + + +-+-+-+-+-+ +-+ + +-+ +-+-+ +-+ +-+-+ +-+ +-+-+-+ + + +-+-+-+ +-+-+-+
| | | | | |     |         | | |               |   |   |     | | | |   |   |     |
+-+ + +-+-+ + + + + +-+ +-+-+-+ +-+-+ + +-+ + + + + + +-+ +-+-+ +-+-+ +-+ +-+ +-+
|     | | | | | | | |       |   | | | |   | | | |   |   |   | | | |       |     |
+ +-+-+ + + +-+-+ +-+-+-+-+-+ +-+ + +-+ +-+-+-+-+-+-+-+ + +-+ + + + +-+-+-+ + + +
|   | |         | |       | | |   | |     |   | |     | |   | |   |   |     | | |
+ +-+ +-+-+ + +-+-+-+-+ + + +-+ +-+ +-+ + +-+ + + + +-+ + + + + +-+-+ +-+ + + + +
| |     |   |   |     | |   | |   |     | |       | | | | | |         |   | | | |
+-+-+ +-+-+-+ + + +-+ +-+ +-+ +-+ +-+-+-+ + + +-+-+-+ +-+-+ + +-+-+ + + +-+-+-+-+
| |       |   |   | |       |         |   | |       |           | | |   |   | | |
+ + + + + + +-+-+ + +-+-+ +-+-+-+ +-+ +-+ +-+ +-+-+-+ + +-+-+ +-+ +-+ + +-+ + + +
|   | | | |   |       | |       | |   |       | | |   | | |         | | |   |   |
+-+-+ + +-+-+-+ +-+-+ + +-+ + +-+-+ + + +-+ + + + +-+-+-+ +-+ + +-+ +-+ +-+ +-+ +
|     |     | | | |     | | |     | | | | | |       |   |     |   |   |     | | |
+-+ +-+ +-+ + + + + +-+-+ +-+ +-+-+-+ + + +-+ + + +-+ +-+-+-+-+ +-+ + + + + + + +
|   |     |     | | | |   |   |   |   |   |   | |   | |     | | | | | | | |     |
+ + +-+-+ +-+ +-+ +-+ +-+ +-+ + +-+-+ + +-+ + +-+ +-+ + + +-+ +-+ + +-+ +-+-+-+ +
| | | |   |           |   | |     |     |   | | |       | | |   | | |       | | |
+-+ + +-+-+-+ +-+ + + + +-+ + + +-+-+-+-+ +-+ + + +-+ +-+-+ + +-+ + + +-+ +-+ + +
|       |       | | |   | | | |   |   |   |     | | | | |     |   | | | |   |   |
+-+ +-+-+-+ + +-+ +-+ +-+ + + +-+-+-+ +-+-+ +-+-+-+ + + +-+ +-+ + + +-+ + +-+ +-+
| |     | | | |   |   | | | | | |     | | |     | |   |     | | |   |     | | | |
+ + +-+-+ +-+ + + +-+ + + + + + +-+ +-+ + + +-+-+ +-+-+ + +-+ +-+-+ +-+-+-+ +-+ +
|     | |     | | | | |       |     |       |     |     |         |         |   |
+ + +-+ +-+-+-+ +-+ + +-+ + +-+-+ + + + +-+ + + + +-+ +-+-+-+ + +-+-+ + + +-+ +-+
| |     | |   | | | | |   | |     |   |   |   | |       |     |   | | | |   |   |
+ +-+-+ + + +-+-+ + + +-+-+ +-+-+ + +-+ + + +-+-+-+ + +-+ + +-+ +-+ +-+ + +-+ +-+
| |     |     | |       |   |     | | | | |       | |   | | |   |   | | |       |
+ + + + + +-+ + + + +-+ + + + +-+-+-+ + + + +-+-+-+ + +-+ + +-+-+ +-+ + +-+-+-+ +
| | | |     |   | |   | | |   |         | |     |   | |   |           |       | |
+-+-+-+-+-+-+-+-+-+-+-+-+-+-+-+-+-+-+-+-+-+-+-+-+-+-+-+-+-+-+-+-+-+-+-+-+-+-+-+-+
