10
10
+-+-+-+-+-+-+-+-+-+-+
|             |     |
+-+ +-+-+ +-+-+-+ + +
|   |           | | |
+ +-+ +-+ + + +-+ +-+
|   |   | | |       |
+ +-+ +-+ + +-+ + +-+
|   |   | | | | |   |
+ +-+-+-+ + + +-+-+ +
| | |   | | | | |   |
+ + +-+ + +-+ + + +-+
| |     | | |       |
+-+-+ +-+-+ +-+-+ + +
|   |   |         | |
+-+ + +-+-+-+ +-+-+-+
|                 | |
+-+ +-+-+ +-+ + + + +
| | |   |   | | |   |
+ + + +-+ +-+ +-+ + +
|       |   |   | | |
+-+-+-+-+-+-+-+-+-+-+
