40
40
+-+-+-+-+-+-+-+-+-+-+-+-+-+-+-+-+-+-+-+-+-+-+-+-+-+-+-+-+-+-+-+-+-+-+-+-+-+-+-+-+
|   |     |           | |   |       |     |         |   |     |   | |   |       |
+ +-+-+ + +-+ + +-+ +-+ + +-+-+-+-+ +-+-+ +-+-+ +-+-+ +-+ +-+ +-+ + + + + +-+-+-+
|       | |   |   | |     | |     |     |   |       | |   |   |       | | |     |
+ +-+ + +-+ + +-+-+-+ +-+-+ +-+-+ +-+ +-+ + + +-+ + + +-+-+ +-+ + +-+ +-+ + +-+ +
| |   |   | |   |       |     |           |   |   |     | |     |   | | |   | | |
+-+-+ + +-+ +-+ +-+-+-+ + +-+-+-+ +-+ +-+ +-+-+ +-+ + + + +-+ +-+-+-+-+ + + + + +
|   | | |   | |             | | | |   | | |   | |   | | |     |   |   |   | |   |
+ +-+-+ + +-+ +-+ +-+ +-+ +-+ + + + +-+ + + +-+-+-+ + +-+ +-+-+ +-+-+ + + + + +-+
|               | |     | |     | |   |       | |   | |     | | | |     | | |   |
+ +-+-+ +-+-+-+ +-+-+-+ +-+-+ +-+-+-+-+-+-+ +-+ + +-+ +-+-+ + + + +-+-+-+ + + +-+
|   |     |   | |     |           | |     |     | |   | | | | |     | |   | |   |
+-+ +-+-+ + +-+ + +-+-+-+ +-+-+ +-+ +-+-+ +-+-+-+ +-+-+ + + + + + +-+ +-+-+-+ + +
|   | | | | | | | |       |               |   |     |   |       | |   | |     | |
+-+-+ + + + + + + + + + +-+-+-+ +-+ + + + + +-+ +-+ +-+ + +-+ +-+-+ +-+ + + + + +
|     |       | |   | | |     | | | | | |     |   |         | | |     |   | | | |
+-+ +-+ +-+-+ + +-+-+ +-+-+ +-+ + +-+-+-+-+-+ +-+-+-+-+ + +-+ + +-+ + + +-+-+ +-+
|           | | |     |   |   |   | | |     |   | |     |   |   | | |     |   | |
+ + + + +-+-+ +-+-+ + + + +-+ + + + + +-+ +-+ +-+ +-+ + +-+-+ + + + + +-+-+ +-+ +
| | | | |   | |   | | | | |   | | |   | |         |   | | |   | |   |   |   |   |
+ + +-+ + + +-+ +-+ +-+-+ + +-+ + + + + + + +-+-+ + +-+-+ + +-+-+-+ + +-+-+-+-+ +
| | |   | | |     |     |       |   | |   |   |   |   |       |     |       |   |
+ +-+-+-+-+ +-+ +-+-+ +-+-+-+ + +-+-+-+-+ + +-+-+-+-+-+-+ +-+ +-+-+ + +-+ +-+-+ +
|     |       | |     |   |   |   |       |       | |     |   |     |   |   |   |
+ + +-+-+-+-+ + + + + +-+ + +-+-+-+-+-+ + +-+-+ +-+ + +-+-+-+ +-+-+ +-+-+ +-+ +-+
| | |     |       | |   |           |   | |     | | |   |   | | | | |   |     | |
+ +-+-+ + + +-+ +-+-+-+ +-+ +-+ + +-+-+-+ + +-+ + + +-+ + +-+ + + + +-+ +-+ + + +
|     | | | |     | |   |     | | | |     |   |   |   | |       |     |     |   |
+-+ +-+-+ +-+-+-+-+ + +-+-+ +-+-+ + +-+-+ +-+ +-+ + + +-+-+ + +-+ +-+ + + +-+-+-+
| | | |       |     | |   |   | |     |   |     |   | | | | | |     | | |   |   |
+ + + +-+ +-+-+ +-+-+-+ + + +-+ +-+ +-+-+-+ +-+-+-+ + + + + +-+-+-+-+-+ + +-+ +-+
|     | |       |   | | | | |       |     | | |   | |     |             |     | |
+-+-+ + + +-+-+ + + + + +-+-+-+-+ + + +-+-+-+ +-+ +-+ +-+-+ +-+ + +-+ + + +-+-+ +
|         |     | | | |     |   | | | |   |         |     | |   | | | | |     | |
+ +-+-+ +-+ +-+ + + + + +-+ + +-+-+-+ +-+ + + + +-+-+ +-+-+-+-+ + + + + + +-+-+ +
|     |   | |   | |   | |           |       | |     | | |   |   |   | | | |     |
+ +-+-+-+-+ +-+ + +-+-+ + + +-+ + +-+-+-+ +-+-+ +-+-+ + + + +-+-+-+-+ +-+-+ +-+ +
| |   | | | |           | |   | |             | | | | |   | |         |   |   | |
+-+-+ + + +-+-+ +-+ +-+-+-+ + + +-+-+-+-+-+-+ + + + + + +-+ +-+-+-+ + +-+ + +-+ +
|     |   |       | |     | | | | |           |   |       |         | |   | |   |
+-+ +-+ +-+-+-+-+ +-+-+-+ + +-+-+ +-+-+ +-+-+ +-+-+ +-+-+ +-+-+ +-+-+-+-+ + +-+ +
|       |   | | | |   |     |       | | |       | | |       | |   |   | |   | | |
+-+ +-+-+-+ + + +-+ +-+-+ +-+ +-+-+ + +-+-+ +-+-+ + + +-+ +-+ +-+-+ +-+ +-+ + + +
|             | |   |       | | |   | |     |       | | | |                 | | |
+ +-+ +-+-+ +-+ +-+ + +-+-+-+ + + + + + +-+-+-+ +-+ +-+ + + +-+ + +-+ +-+-+-+ + +
| |     |       |         | | | | |   | |   |   | | |     | | | |   | |   |     |
+-+-+-+-+ +-+-+-+-+ +-+-+-+ + + + + + +-+-+ + + + +-+ +-+ + + + +-+-+ + +-+-+ + +
|   |   |     |   |     |   | |   | |       | |   |   | |   | | | |     | |   | |
+ +-+-+ +-+-+ + + +-+ +-+ + + +-+ +-+-+-+-+ +-+-+ + + + +-+ + + + +-+-+-+ +-+ + +
|       |     | |     |   |   | | |     | | |     | |     |   | | |   |     | | |
+ +-+-+ + +-+-+-+-+ + +-+-+-+-+ +-+-+-+ + + +-+ +-+ +-+ +-+-+-+ + +-+ +-+-+ +-+-+
| |         |   |   | |       | | |   |   |   | | | | |   |       | |       |   |
+ +-+-+-+ +-+-+ + +-+-+-+-+-+ + + + + +-+ + +-+ + +-+ + +-+-+-+ +-+ +-+ + + +-+ +
| |     | |         |   |     |     | |           |   | | | |     | |   | | |   |
+ + +-+ + +-+ +-+-+-+ + + + +-+-+ +-+ + + + +-+ + +-+ +-+ + +-+ + + + +-+-+ + +-+
|     | | |   |   |   | | |         |   | |   | |     |   |     |   | |   |   | |
+ +-+-+-+-+ + + +-+ + +-+ + +-+-+-+-+-+-+ +-+-+-+-+-+ + + +-+-+ +-+-+-+ + +-+ + +
|       | | |       | | | | | |   | |   |       | |   | |   | |     | | | |     |
+-+ + +-+ +-+ +-+-+-+ + +-+ + +-+ + + +-+-+-+ + + +-+-+ + + + +-+-+ + + + + +-+-+
| | | |         |     | | |   |         |     |         | |   |     |   |       |
+ + + + +-+-+-+-+-+ + + + +-+-+-+-+ +-+-+-+-+ +-+-+-+-+-+-+ +-+-+ + + + +-+ +-+ +
|   |       |     | | |   |     |     | |       |     | | | |   | |   |   | |   |
+ +-+ +-+-+-+-+-+ + +-+-+ + +-+ +-+ + + + +-+ +-+ + +-+ + +-+ + + +-+-+-+-+-+ +-+
| |     | |   |   | | | | | |     | | | |   | |   |     | |   |     |   | | | | |
+-+-+ +-+ + +-+-+ + + + + + +-+ + + +-+ + +-+-+-+-+ +-+ + + +-+-+-+ + +-+ + + + +
|     |       |   |           | | |         |   |   | |       |   |   | |     | |
+-+-+ +-+ +-+-+-+ +-+-+-+-+ + +-+-+-+ +-+ +-+ + +-+-+ +-+ +-+-+ +-+ + + +-+-+-+ +
|   |   |       |         | | | |     | | |   |       |         |   | | | |   | |
+-+ +-+ +-+-+ +-+-+-+ + +-+-+ + +-+-+ + + + +-+ + +-+ +-+ +-+-+-+ +-+ + + + +-+ +
|               |     | |     | | |     | |   | |   | |   |       |     | |     |
+ + + +-+-+-+-+ +-+-+ + +-+-+-+ + + + +-+-+-+ +-+-+-+-+-+-+-+ +-+ + +-+ + + +-+-+
| | |   | |     |     |   |       | | | | | | | |   |     |   |   |   | |   |   |
+-+-+ +-+ + + +-+ +-+-+-+-+ +-+-+-+ +-+ + + + + +-+ + + +-+ +-+-+-+ +-+-+ +-+ +-+
|   |   | | |   |         |     | |   | |         | | | |   |           |     | |
+-+ +-+-+ + +-+ +-+ +-+-+ + +-+ + + +-+ +-+ +-+ + + + +-+-+-+ +-+-+ +-+ + + +-+ +
|   |       |         |     |   |     |   | |   |   |     | |   |   |     |     |
+ +-+-+ +-+ +-+-+-+-+ + +-+ +-+-+ +-+ + +-+ + + + +-+ +-+ + +-+ + +-+ + + + +-+ +
| |   |   |     |     |   |   |   | |     | | | |   | | |   |   | |   | | |   | |
+ +-+ + +-+-+-+ +-+-+-+-+ + + +-+ + + +-+-+-+ +-+ + + + + + + +-+-+ +-+-+ + + + +
|       |       |         | | |   |         | |   |     | |   |     |     | | | |
+-+-+-+-+-+-+-+-+-+-+-+-+-+-+-+-+-+-+-+-+-+-+-+-+-+-+-+-+-+-+-+-+-+-+-+-+-+-+-+-+
