50
50
+-+-+-+-+-+-+-+-+-+-+-+-+-+-+-+-+-+-+-+-+-+-+-+-+-+-+-+-+-+-+-+-+-+-+-+-+-+-+-+-+-+-+-+-+-+-+-+-+-+-+
|       |             | |   | | |       |     |   |   |     |     | | | |                 |   | |   |
+ +-+ + + +-+-+-+ + +-+ + +-+ + +-+-+ +-+ + +-+ + + + +-+-+ + +-+-+ + + +-+ +-+ +-+ +-+-+-+ +-+ +-+ +
|   | |   |   |   | |       |   |   | |   | |   | | |   |       |   | |     |   |     | |           |
+-+ + +-+ + +-+-+-+-+ + +-+-+-+ + + + + +-+ +-+-+ +-+-+ +-+ +-+-+ +-+ +-+ +-+-+ +-+-+ + +-+-+ + + + +
|   | |   | |     |   |     |   | |     |     |       | |       |     | |   | |     | |       | | | |
+ +-+ + + + + +-+ +-+ + + +-+ +-+ + +-+ +-+-+ +-+-+-+ + + +-+ +-+ +-+-+ +-+-+ + + +-+-+ +-+-+-+ +-+ +
| |   | |   | |   |   | | |       | | |   |   |   |   |   |             | |     | | | |       | | | |
+-+ +-+ + +-+-+ +-+-+ +-+ + +-+ +-+-+ + +-+-+-+ +-+ + + + + + +-+-+-+-+ + +-+-+ + + + +-+ + +-+-+ +-+
|   | | | |       |   |   |   |     |       |   | | |   | | |   |         |   | | |   |   |     | | |
+-+ + +-+-+ + +-+-+ + +-+-+ +-+-+ + + +-+ +-+ + + +-+-+ +-+-+ + +-+ + + +-+ + + + +-+ +-+-+-+-+ + + +
|   |       |   | | |         |   | |   |     |   | | | |   | | |   | | | | |   | |     |           |
+ +-+-+-+ +-+-+ + +-+-+ +-+ +-+-+ +-+ + +-+ + + +-+ + +-+ + + + + + +-+-+ + +-+ +-+-+-+ + +-+ +-+ +-+
|           | |     |   | |   | | |   |   | | | |   | |   |   | | | |   |   |     |     |   | | | | |
+ +-+-+ + +-+ +-+ + +-+ + +-+ + +-+-+-+ +-+ + + + +-+ + + +-+-+ +-+ + + +-+-+ + +-+-+ + + + +-+ + + +
| | |   | |     | | |   |     | |     | |   | |       | | | |     | | | |   | |       |   |   |     |
+ + +-+-+ + +-+-+-+-+ + + +-+ + +-+-+ +-+-+-+-+-+ + + +-+-+ + +-+-+-+-+ + +-+ +-+-+-+ +-+-+-+-+-+ +-+
|     | |   |       | | | | |       | |         | | |     |     |   |           | |           |     |
+ +-+-+ +-+ +-+ +-+ +-+ + + + + +-+-+ +-+ +-+ + +-+-+-+-+ +-+-+ + + + +-+-+ +-+ + + +-+-+ +-+-+-+ + +
|   | |     | |   |   | |   | | |   |   | |   | |     | | |       | | |     |   |     |   | |   | | |
+-+ + + +-+-+ +-+ +-+ + +-+-+ +-+-+ +-+ +-+ +-+ + +-+ + +-+-+-+-+ + + + +-+ +-+-+-+ +-+-+-+ + +-+-+ +
|     | |     |   |       | |   |     |     |     |     |     | | |   |   | |         | | | |     | |
+ +-+ +-+-+-+ + + +-+ + + + +-+-+ + +-+-+ +-+ + + +-+-+-+ +-+ + + +-+ + + +-+ +-+-+-+-+ + + + +-+-+-+
|   |     |     |   | | |   | | | | | |     | | |       | |     | |   | | |         |   |     |   | |
+ +-+ + +-+ +-+-+-+-+ + +-+-+ + +-+ + + +-+ +-+ +-+ + +-+-+-+ +-+-+-+ +-+-+-+-+ +-+-+-+ +-+ + + +-+ +
| |   |           |   |     |   |       | | | | |   | |     |         |     |       | | |   |       |
+ + +-+-+ + +-+-+-+-+-+-+ +-+ +-+ +-+-+ + + + + +-+-+-+-+-+ + +-+-+-+-+-+ + +-+-+-+ + + + + +-+-+-+ +
| | |   | |     |     |     |   |     | | | | | | |   | |     |     | | | |     | | |     |   | | | |
+-+ + +-+ +-+-+-+ + +-+-+ +-+ +-+ +-+ +-+ +-+ + + + +-+ + + +-+-+ + + + + + + +-+ + +-+ +-+-+ + + + +
|     |   |   |   |   | |   | |   | |       |     |   |   |     | | |     | | |       | | |     | | |
+ +-+-+-+ + +-+-+ + +-+ + + + + +-+ + + + +-+ + +-+ + +-+-+-+ +-+-+ +-+-+ +-+ +-+-+ + + + +-+ +-+ +-+
| | |   |     | | |   |   |   | |     | |   | | | | | |     | |   |       |   | |   |   |     |     |
+ + +-+ +-+ +-+ +-+ +-+-+-+ +-+ +-+ +-+ +-+ +-+ + +-+ +-+ +-+-+-+ +-+-+-+-+ +-+ +-+ +-+-+ + +-+ +-+-+
|   |     | |   |   |     |       | | | |   | |           |             |   |   |       | |       | |
+ +-+ + +-+ + + +-+ +-+-+ +-+-+-+ + + + +-+-+ + + +-+-+ + + + +-+-+-+ +-+-+ + + +-+ +-+-+ +-+-+-+-+ +
| |   |     | |       |       |   |   |   | |   | |     | | |       |     |   | |       | |   | |   |
+ +-+ +-+ +-+-+-+-+-+ + + +-+-+ + + +-+-+-+ +-+-+ +-+ +-+ +-+-+-+ +-+-+ + + +-+-+ + +-+-+-+ + + +-+ +
| | |   | | |       | | |   | | | | | |   |     |   | |   |     | | |   |     |   |     |   | |   | |
+-+ + +-+-+ + + + +-+ + +-+ + +-+-+ + + +-+-+-+ + + +-+-+ +-+-+ +-+ +-+-+ + +-+ +-+-+-+-+-+-+ + + + +
| |   |   | | | | |     | |       |   |     |   | |   |     |       | |   |           |   |   | |   |
+ + +-+-+ + +-+-+ + +-+ + +-+-+ + +-+ +-+-+ + + +-+ +-+-+ +-+-+-+-+ + + +-+ +-+-+ +-+-+-+ + +-+-+ + +
|   |       |         | |     | |   |   |   | |     | |     |     | | | |   |     |       |       | |
+-+-+ +-+ +-+ +-+ +-+-+-+-+ +-+-+-+ + +-+ +-+-+ +-+-+ +-+ + +-+ +-+ + +-+-+ +-+-+-+ +-+ +-+ +-+-+-+-+
|   | |   |   | | |         |     |           |     | |   |     | | |   |   | | | | | | | |     | | |
+-+ +-+ + +-+ + +-+-+ +-+ +-+ + +-+-+-+ +-+-+ + + +-+ + +-+-+-+-+ + +-+ + +-+ + + + + +-+ + +-+-+ + +
|       |     |   | |   | |   |   |     |     | |     | |   |   |     | |     |   |       |     | | |
+-+-+-+-+ +-+ + +-+ + +-+ +-+-+ +-+-+-+-+ +-+ +-+-+ + +-+ +-+ +-+ + + + + +-+-+-+ +-+-+ +-+-+-+ + + +
| |         |       | |       |   |   |     | | |   |     |   | | | |           | |   |       | |   |
+ +-+-+ + +-+ +-+ + + +-+ +-+-+ +-+ +-+ +-+-+ + +-+-+ +-+ + + + +-+-+-+ + +-+-+-+ + + +-+ +-+-+ + +-+
|     | | |   |   | | |         | | |     |   |     |   | | |     |   | | | |       | |           | |
+ +-+ +-+-+ +-+-+-+ +-+ +-+-+-+-+ + +-+ +-+-+ +-+-+ +-+-+ +-+ +-+ + +-+-+ + +-+-+-+ + +-+ +-+ +-+-+ +
| | |   |   |   |   | |       |           |   | | |   |     |   |   | |         |   |       | |     |
+-+ + + +-+-+ +-+ +-+ + +-+ +-+ + + +-+ +-+-+ + + + + + + + + +-+-+-+ +-+-+-+ + + +-+-+ + +-+-+-+ + +
|   | | | | | | |       |   |   | |   |     | | | | |   | | |   |       |     | |   | | | |       | |
+ +-+-+ + + + + +-+ + +-+-+ +-+-+ +-+-+-+ +-+-+ + + +-+-+-+ +-+ +-+ + + + +-+-+-+-+ + + + +-+ +-+ +-+
|   |   | |         | |   | |   | | | |           |       |       | | | |           |   | |     |   |
+ +-+ +-+ + +-+-+ +-+-+-+ +-+ +-+ + + + + +-+-+ +-+-+-+-+ + +-+-+-+ + +-+-+-+ +-+ + + +-+ + +-+ + + +
|   |       |   |   |         |   |   | | | |     |       | |     | | |         | | | |       | | | |
+ + +-+-+ +-+-+ + +-+-+ +-+ +-+-+-+ + +-+-+ +-+ + +-+ +-+ +-+-+ +-+ + +-+ + + + + + +-+ +-+-+ + +-+-+
| | |           |         |   |   | |     |   | | |   |     |       | |   | | | | |   |   |   |     |
+ + + +-+ +-+ +-+-+-+ + +-+ + + +-+-+-+ +-+ +-+-+ +-+-+ + +-+-+ + + +-+ +-+-+-+ +-+ + +-+ +-+-+-+-+-+
| |     |   |     | | | |   |         |   |         |   |       | |   |     | | |   | |         |   |
+ + +-+-+-+ +-+ + + + + +-+-+-+-+ + +-+-+ +-+ +-+-+ + +-+-+ +-+-+-+-+ + + +-+ + +-+-+-+ + +-+-+-+ +-+
| |   | |   |   |   | |   |       | |     | |   | | |   | | |     | |   |   | |   | |   |     |     |
+-+-+ + +-+-+-+ +-+ +-+ +-+-+-+ +-+-+ + +-+ +-+-+ +-+-+-+ +-+ +-+-+ + +-+-+-+ +-+-+ +-+-+ + + + +-+ +
|     |   |   |   |   |     | | | |   | | |     |   |   |       |   |   | |   |       | | | |   |   |
+ +-+-+-+ +-+ + +-+ +-+-+ + + + + + +-+-+ +-+ +-+-+ + + +-+-+-+ +-+ +-+ + + +-+ +-+-+-+ +-+-+ +-+ +-+
|   |   | |   |   | | |   | |         |   |       | | |   |                 |           | |   | | | |
+-+-+ +-+ +-+ + +-+-+ +-+-+ +-+-+ + +-+ +-+ +-+-+ + +-+ + +-+ +-+ +-+ + +-+-+ +-+-+ +-+-+ + + + + + +
|     | |   |         | |   |   | | |   | | |   |   |   |     |     | | | |   | |         | | | |   |
+-+-+ + + +-+ +-+-+ +-+ +-+-+ + +-+-+-+ + +-+ + +-+ +-+-+ +-+ +-+ +-+ + + + +-+ +-+ +-+ +-+-+-+ + + +
|       |     |   | |       | | | |     |   | | |     |     |   | |   | |   |   | |   |     | |   | |
+ + + +-+-+-+-+-+ + + +-+-+ +-+ + + +-+ + +-+-+ +-+-+ +-+ +-+-+-+-+ + +-+ + + +-+ +-+-+-+-+-+ +-+ +-+
| | | |         | | |   | | |         |       |   |   | | |     | | | |   | |       |               |
+ +-+ + +-+ +-+ + + +-+-+ + + +-+ + + + +-+ + +-+ +-+ + + +-+-+ + + +-+-+ +-+-+ +-+ +-+ +-+ +-+-+-+-+
|   | |   |   | |     |     | |   | | | | | | |       |           |   |         | | |   |       |   |
+-+-+ + +-+ +-+-+-+-+ +-+-+ +-+ +-+ +-+-+ +-+ + + +-+-+ + +-+ +-+ +-+-+ +-+ + +-+ + +-+-+-+-+-+ +-+ +
|   |     | | |     | |           |         |   | |   | |   | |   |   | |   | |     | |   |   | | | |
+-+ + +-+-+ + +-+-+ +-+ + + +-+ +-+ +-+ +-+ + + +-+-+ +-+-+ +-+-+ + + + +-+ + + + +-+ + + +-+ +-+ + +
| |     | |   |       | | | | | |   |     | | |     |   |   | |   | |     | | | | |   | |     |     |
+ +-+-+-+ + + +-+-+ +-+-+-+-+ +-+-+ +-+ +-+-+-+-+-+ + +-+-+ + + +-+ +-+-+-+-+ + +-+ + +-+ +-+-+ +-+-+
|   |   |   |       | |   | |   | |   | | | | |       |     |           |   | |   | |       |       |
+ +-+-+ + + +-+-+-+ + + +-+ + +-+ +-+-+ + + + +-+-+ +-+-+-+ +-+-+-+ + + + +-+-+-+ +-+-+-+ +-+ +-+ +-+
|         |   | | |   | | | |       |   |   |         |   |       | | |   |       |         | |   | |
+ +-+ +-+-+-+-+ + + +-+ + + +-+ + +-+ +-+ + +-+ +-+-+-+ + +-+ +-+-+-+ +-+ +-+ +-+ +-+-+-+ + +-+-+ + +
|   |   | |       |           | | |   | | | |     |   | |     |       |   |   |     |   | | |       |
+ +-+-+-+ +-+-+ +-+ +-+ +-+-+-+-+ +-+ + +-+ +-+ +-+-+ + +-+ + +-+ +-+ +-+-+-+-+-+-+-+ +-+ +-+-+-+-+ +
| |     |             |     | |     | | |   |           |   | |   |               |     |     |     |
+ +-+-+ +-+-+ +-+-+ +-+ +-+ + + +-+-+ + + +-+ +-+-+ + + +-+-+-+-+-+-+ +-+-+-+ +-+ +-+-+ +-+ +-+-+ + +
|   | |   | | |     |   | |       | |     |     |   | | |   |   | | | | |       | | |       |     | |
+ +-+ +-+ + + +-+ +-+-+-+ +-+-+ +-+ +-+ +-+-+ +-+-+-+-+-+ + + +-+ + + + + + + +-+ + +-+ + +-+ + + + +
| |       |     |     |         | |     |       |   |     | |   | |     | | | | | | |   |   | | | | |
+-+-+ +-+-+-+ +-+-+ +-+ +-+-+-+ + + +-+ +-+-+ + + +-+-+-+ +-+-+ + + +-+ + + + + + + +-+-+ +-+-+-+-+ +
|       |       |   |   | |   |       | | | | |   |     | | |     |   | | | |   | |       | |   |   |
+ + + + + +-+-+-+-+-+ +-+ + + + + +-+ + + + +-+ + +-+-+ + + + + +-+ +-+ +-+-+-+-+ + + +-+-+ + +-+ +-+
| | | |   |   |   |     |   |   | | | | | | |   | |   |     | |     |   | |         | |           | |
+-+ +-+ + +-+ + + + +-+-+ + +-+-+-+ + + + + + +-+-+ + +-+ +-+-+ +-+ +-+-+ + +-+ + +-+ + +-+-+-+-+ + +
| | |   |   | | | |     | | | |       | | |     |   |   | | | | |   |   |     | | | |   | |         |
+ + + + + + + + +-+ + +-+ + + +-+-+-+ +-+ + + +-+ + +-+-+ + + + +-+ + +-+ + + +-+ + + + + + + +-+ +-+
|   | | | |     |   | |   |         | |     |     |           |   | |     | |   | |   | |   |   |   |
+-+-+-+-+-+-+-+-+-+-+-+-+-+-+-+-+-+-+-+-+-+-+-+-+-+-+-+-+-+-+-+-+-+-+-+-+-+-+-+-+-+-+-+-+-+-+-+-+-+-+
