15
12
+-+-+-+-+-+-+-+-+-+-+-+-+-+-+-+
|   |   |   |     | | |     | |
+ +-+-+ + +-+-+ +-+ + +-+-+ + +
|   |   |     |     |         |
+ +-+ + +-+-+ +-+-+ + + +-+ + +
| | | | |   |     | | | | | | |
+ + + +-+ +-+ + + + + + + +-+ +
|   |       | | |     |     | |
+-+ + +-+ + + +-+-+-+ +-+ +-+ +
| |     | |         | | | |   |
+ + + +-+-+-+ +-+ +-+-+ +-+-+ +
|   |   | |   | |     |   | | |
+-+-+ +-+ +-+-+ + +-+-+-+ + + +
|   |   | |         | |   |   |
+ +-+ + + +-+ + +-+-+ +-+ + +-+
|   | |   | | | |     | |   | |
+ +-+-+ +-+ + +-+-+ + + + + + +
|       |     | |   |     | | |
+-+ +-+-+ +-+ + + +-+-+ + + + +
|   |     |     |     | | |   |
+ +-+-+-+ + +-+-+ + +-+ +-+-+-+
|   |     |     | |   | |     |
+-+ + +-+-+-+-+-+-+ + + + +-+-+
|   |       |       | |       |
+-+-+-+-+-+-+-+-+-+-+-+-+-+-+-+
