50
50
+-+-+-+-+-+-+-+-+-+-+-+-+-+-+-+-+-+-+-+-+-+-+-+-+-+-+-+-+-+-+-+-+-+-+-+-+-+-+-+-+-+-+-+-+-+-+-+-+-+-+
|   |       |   |         |     | |     |   |   |   |   | | |     |       |             |         | |
+-+ + +-+-+-+ + +-+-+-+ +-+-+ +-+ +-+-+ +-+ + +-+ +-+ + + + +-+ +-+-+-+-+ +-+ +-+ +-+ +-+ +-+-+ +-+ +
|       |     |     |   | |       | |     | | | |   | | | | |     |   | |   | | |   |   |     | | | |
+-+ + +-+-+ + + +-+ + + + +-+ +-+-+ +-+-+ + + + + + +-+ + + + +-+ + + + + +-+ + + +-+ +-+ +-+-+-+ + +
|   |       | | | |   |   |         |           | |     |     |   | | |     | | |   |       | |     |
+-+-+ +-+ +-+-+ + +-+-+ +-+-+-+ +-+-+ +-+ +-+-+ + +-+ + + +-+-+-+ +-+ +-+-+ + + + +-+-+-+-+-+ +-+ +-+
|   | |   |   |   | | |     |   |       |   |   |   | | | | | | |               |   |     |         |
+ +-+ + + +-+ +-+-+ + +-+-+-+ + + +-+ + + +-+-+ +-+ +-+ + + + + +-+-+-+ + +-+ +-+-+ +-+-+ +-+-+ + +-+
| |   | | |   |   | |     |   |     | | |     |   | |             |     |   | |   | |   |   |   |   |
+ +-+-+ +-+ + + +-+ + +-+-+ +-+-+ +-+ +-+-+-+-+-+-+ +-+ +-+ +-+-+-+-+-+-+-+ +-+ +-+-+ + +-+ + +-+-+-+
|   |     | |       | |     | |     |   |       |     |   |   |   | | | | | | | | | | |         |   |
+-+ +-+-+ +-+ +-+ +-+ +-+-+-+ +-+ +-+-+-+-+ +-+-+ +-+-+ +-+-+-+-+ + + + + + + + + + + +-+ +-+-+-+ + +
| | | |   |   |   |       | |   | |       |     |     |               | |     |   |   | |       | | |
+ + + +-+ + +-+ +-+-+-+ +-+ + +-+ +-+ +-+-+ +-+ +-+-+-+ +-+ +-+ +-+ + + +-+ +-+ +-+-+ + + +-+-+ + +-+
|     | |     |       |           |   | |     |           | |     | |   |   |           |   |       |
+ +-+-+ +-+ +-+-+ +-+ + +-+-+-+ + + +-+ +-+ +-+ +-+ +-+ +-+-+-+-+-+-+ + +-+-+ +-+ +-+ +-+-+ +-+ +-+-+
|     |   |     |   | | |       | |         |   | |   | | | | | |   | |       |   |       |   | |   |
+ +-+ + +-+-+-+-+-+-+ + +-+ +-+-+-+-+-+ +-+-+-+-+ +-+ +-+ + + + + +-+-+ +-+-+ + +-+-+ +-+ +-+-+ + +-+
| |   |   |   |       | | |   | | |   | |     |   |   |       |   |     |   | |   | | | |   |   |   |
+ +-+-+ +-+-+ +-+-+ +-+-+ + +-+ + + + +-+ + +-+ + + +-+-+-+-+ +-+ +-+-+-+ +-+ + + + +-+ + +-+ +-+ +-+
| | |             |   |             | |   | | | | |   |           |     | |   | | | |   |   | |   | |
+ + + +-+-+ + +-+-+-+ +-+ +-+ +-+ +-+ + +-+ + + +-+-+-+-+ +-+ +-+-+-+ +-+ + +-+-+ + + +-+ +-+ + +-+ +
|   |     | |   |           | |   |   | |   |     |       | | | | |     | | | |     | |   |         |
+ +-+ +-+ + +-+ + +-+-+-+ +-+-+ +-+-+ +-+ + + +-+ + + +-+ + + + + +-+-+ + +-+ +-+ + + +-+ + + +-+ +-+
|   | |   |   |   | |   | |       | |   | |   | |   | |     |     |     |   |   | | | | | | | |     |
+ + + + + +-+-+ + + + +-+-+ +-+ +-+ + + +-+ +-+ + +-+-+-+-+-+-+-+-+-+ +-+-+ +-+ +-+-+ + + +-+-+-+ +-+
| |   | | | |   |   | |   |   |     | |   |   |         | |   |           |     |     |   |     |   |
+-+-+-+-+-+ +-+-+ +-+ +-+ +-+ + + +-+ +-+-+ + +-+-+-+ +-+ + +-+ + +-+-+ +-+ + +-+-+-+ + +-+ +-+-+-+-+
|           |   | |       | | | | |   | |   |     |     |       | |   |     | |   |   |             |
+-+ + +-+-+ + +-+-+-+-+ + + + +-+-+-+ + +-+ +-+ + +-+-+-+-+ +-+-+-+ +-+ +-+-+-+-+ + + +-+ +-+ + +-+ +
|   |     |   |   |     | |   |     |         | | |   | |     |     |   |   |       |   | |   | |   |
+ + + +-+-+-+ + +-+ + + +-+ +-+ + + + +-+ + +-+-+ + +-+ +-+-+-+-+ + +-+ + + + +-+-+-+ +-+ + + +-+-+ +
| | | | | | |     | | | | |     | | |   | | | |         |   | | | |       | |     | | |   | | |   | |
+ +-+ + + + + +-+ +-+-+ + +-+ +-+-+-+-+-+-+ + +-+-+-+ + + + + + + +-+-+ +-+-+ +-+-+ +-+-+ +-+ +-+ + +
| | | |     |   |             |       |       | |     | | |       |   |   |           |   |     | | |
+ + + +-+ +-+ +-+-+ +-+-+-+ + +-+-+ + +-+ +-+ + +-+-+-+-+ +-+-+-+ +-+ +-+-+-+ +-+ +-+ +-+ +-+ +-+ +-+
| | | |     |   | | |       |   |   | |     | | |       | |   |       |         | |     | |   |     |
+ + + + +-+-+-+-+ +-+-+ +-+-+ +-+ +-+-+-+ +-+ + +-+-+ + +-+-+ +-+ + +-+ + +-+-+-+-+-+ +-+ + +-+-+ +-+
| | | | | | |         | |   | |       |   | | |       |   |   | | | |   |   |     |       |     |   |
+ + +-+ + + +-+-+ +-+ + +-+ + + +-+ + +-+ + + +-+-+-+-+-+ +-+ + + +-+-+-+ +-+ + +-+-+ +-+-+ +-+-+ +-+
| |       |   | |   |     |   |   | | |     |     |   | |         | | |     | |     |   |           |
+ +-+ +-+-+ +-+ +-+ +-+ +-+-+-+ + + + +-+ + +-+-+-+-+ + +-+ +-+ +-+ + +-+-+ + + + +-+-+-+-+ +-+-+-+-+
| | | |       | |   |   |       | | | | | | | | |     |     |                 | | | |   |     |     |
+ + + + +-+ +-+ +-+ + +-+-+-+-+ +-+-+ + + + + + +-+ + +-+-+ +-+-+-+ +-+ +-+ +-+-+ + + +-+-+-+ +-+-+ +
| |       |       | |         |   | | |   |       | |     |   |   |   |   | |     |   |   |         |
+-+-+ +-+-+-+-+ +-+-+ +-+-+-+-+ + + +-+ + + + +-+-+ +-+ +-+ +-+-+ + + + +-+ +-+-+-+ +-+ +-+ +-+-+ +-+
|   | |   |     | | |     | |   |       | | | |   |   |           | | |   | |           | | |       |
+-+ + + +-+ +-+-+ + +-+-+-+ + +-+-+-+-+ +-+-+ + + +-+ +-+-+ + +-+-+-+ + +-+-+ + +-+ +-+ + +-+ + +-+-+
|   | | |   |     |     |       |     |     | | |   | | |   |   |   | | | |   | |     | | |   |   | |
+-+ + + + +-+-+-+ + +-+ +-+-+ +-+ +-+-+-+ +-+ +-+ +-+-+ +-+ +-+-+-+ + +-+ + +-+-+-+-+-+ + +-+ + +-+ +
|     |         |     | |   |   | |   | | |   |         |     | | |       | |     | |       | |     |
+-+-+ +-+-+-+-+-+-+ +-+ + + + + + + + + + +-+-+ +-+ +-+-+ +-+-+ + + + +-+-+ +-+ +-+ + +-+ + +-+-+-+ +
|   | |         | | |     |   |   | |   |         | |       | |     |     |       |   |   |   |     |
+ +-+ + +-+-+-+ + +-+-+ +-+ +-+ + +-+ +-+-+-+ +-+-+-+-+-+ +-+ +-+-+-+-+-+ + +-+-+-+ +-+-+ +-+ + +-+-+
|     |   |       |     | |   | |     |     |   |                 |     | | |   |   |       |   |   |
+ +-+ +-+-+ +-+ + + + + + +-+-+ + +-+ + +-+ + + +-+-+ + +-+-+-+-+ +-+ + +-+-+ +-+ +-+-+-+ +-+ +-+ +-+
| | |     |   | | | | |     | | |   |   |   | |       |   |   |   |   |   |     |   |   |   |       |
+ + +-+-+ +-+-+-+ +-+-+ + + + + + + +-+ +-+-+ +-+-+ + + +-+-+ + + + +-+ +-+ +-+ + + +-+ + + +-+ +-+ +
| |           | | |   | | | |   | | | | | | |   |   | |   |   | | | | |       | | |     | |   | |   |
+ +-+-+-+-+-+ + + + + +-+-+ + + +-+-+ +-+ + +-+-+-+-+ +-+ + + +-+ +-+ + +-+ +-+-+-+-+-+-+ + +-+-+ +-+
|   |     |         |   |   | |     | |   |       |   |     | | |         | |       | |   | |     | |
+ +-+-+ +-+-+ +-+-+ +-+-+-+-+ + +-+-+ + +-+ +-+-+ +-+-+ + + +-+ + +-+-+-+ + +-+ +-+-+ +-+ + + +-+ + +
| | |       | |   |     |     | |     | |   | | | | |   | |     | |   |   |     | |       | | |     |
+ + + +-+-+-+ + + +-+ +-+-+ +-+-+ + +-+ +-+-+ + + + + +-+-+ +-+ +-+-+ + +-+-+ +-+ +-+-+-+-+-+-+-+ +-+
| |   |   | | | | |   |       |   |   | |     |     | |   | | | |     | | |   |     |   | | | |   | |
+ + + + +-+ + + +-+-+-+ +-+-+ +-+ + + + +-+ +-+ +-+-+ + +-+-+ + +-+ +-+-+ + + + +-+-+-+ + + + +-+ + +
|   | | |   |       | |   | |   | | |     | | | |   |       |         |   | |   | |   |   |   |     |
+ + +-+ +-+ + +-+ +-+ + + + +-+-+-+-+ + + + + + +-+ +-+ +-+-+-+-+-+-+-+ +-+ +-+ + + +-+ +-+ + +-+ +-+
| | |     |     | | |   |   |         | |         |   |         |     |       | | |     |   |   |   |
+-+-+ + +-+ + +-+ + + + +-+ +-+ +-+-+-+-+ + +-+ +-+ +-+ +-+ +-+-+ +-+-+-+-+-+ +-+ + +-+-+-+-+ + +-+-+
|     | | | | | | | | | |   |       |     |   | |   |     | | | | |     | | | | | |   | | |   | |   |
+ +-+-+-+ +-+ + + + +-+ +-+ +-+-+ +-+ +-+-+ + + + + + +-+-+ + + + + + + + + +-+ + + +-+ + + +-+ +-+ +
| | | |     | |   |   | | |     |   | | | | | |   |   | | |     | | | | |         |   | | |   | |   |
+ + + + + +-+ +-+-+ + +-+ +-+-+-+-+ +-+ + +-+ +-+-+ +-+ + + + +-+ +-+ +-+ +-+ +-+-+-+ + + + +-+-+ + +
| |   | |     |     |     | |       |     |     |       | | |     |   |   |   |             | |   | |
+ + + + +-+ + +-+ +-+-+ + + +-+-+-+-+-+ +-+ +-+ + +-+-+ + + +-+ +-+-+ + +-+-+ + +-+ +-+-+ +-+ + +-+ +
|   | |   | |   |   |   |     |   | | |     |   | |     |   |               | |   | | | | |       | |
+ +-+ + + + +-+ +-+-+ + +-+-+-+ +-+ + +-+-+ + + + + +-+-+ +-+ + +-+-+ +-+-+ +-+ + +-+ + +-+-+ + +-+ +
| |   | | |   | |     |           |   | | | | | | |     |   | | | | | |       | |     | | |   |   | |
+ + +-+ +-+ +-+ +-+-+ +-+ + + +-+-+ +-+ + + +-+-+ +-+-+-+-+-+-+ + + + + +-+-+ +-+ +-+ + + +-+-+-+ +-+
| | |     | | |         | | |   |     | |   |   |           |     | | |     | | | | |     |     |   |
+ + +-+-+ +-+ + +-+-+ +-+ + + +-+ +-+-+ +-+-+-+ + + +-+-+ +-+ + +-+ +-+-+ + + + + + + +-+ +-+ + +-+ +
| | | |     | |     |   | | |     | |     |     | | |     |   | | |       | |     |   |   | | | | | |
+-+ + + +-+ + + +-+-+ + +-+ +-+-+ + +-+ +-+-+ +-+-+ +-+ +-+-+-+-+ + + +-+-+-+ +-+-+-+-+ + + + + + + +
|         |   |   | | |   | | |     |       |     |   |   | |   |   | | | | | |   |   | |     | |   |
+-+ +-+ +-+-+ +-+-+ + +-+-+-+ + +-+ +-+ +-+ +-+ + + + +-+ + +-+ +-+ + + + + +-+ +-+ +-+-+ +-+-+ +-+ +
|   |   |       |     |         |       |   |   |   | |     |       | |   | |     |       |   |     |
+ +-+-+ +-+ +-+-+-+-+-+-+-+-+-+ + + + +-+-+ + +-+ + +-+ +-+ +-+-+-+-+ + +-+ + + +-+-+ +-+ + +-+-+ +-+
| |     |   |   | |   | | | |   | | | |       |   |   |   | |   | | | |       | |   |   |       |   |
+-+-+ +-+-+ +-+ + + + + + + +-+-+-+ +-+-+-+-+ + +-+ +-+ +-+-+-+ + + + + +-+-+ +-+ +-+-+ +-+-+-+ + +-+
|   | |   | |   | | |   |   |     | | | |     |   |   |     |           |       |   |   |       | | |
+ + + +-+ + + +-+ + +-+-+-+ +-+-+ + + + +-+ + + +-+-+-+ +-+-+-+ +-+ +-+-+-+ + +-+ + +-+-+-+ +-+ +-+ +
| |   |     |   |       |     |       |     | | | |   | |     | |     | |   | |   |   |       |     |
+-+-+ +-+ +-+ + + +-+ +-+-+-+ +-+ +-+-+ +-+ +-+ + +-+ + + + +-+-+-+ +-+ + +-+-+-+ + + +-+-+-+-+ + +-+
| |     |   | |     |   | |       | | | | | | |     | | | | |       | | | |     | | | | |   |   |   |
+ + + +-+-+-+-+ + + + +-+ +-+ +-+ + + + + + + + + + + + +-+ + +-+ +-+ + + + + +-+-+ +-+ +-+ +-+-+ +-+
|   |   |   | | | | |   |       | |   | |   |   | |   |   |   | | |     |   |   |         | |   |   |
+-+ +-+-+-+ + + +-+-+ + + +-+-+ + +-+ +-+ + +-+-+ +-+ +-+-+-+ + + + + + +-+-+ + +-+ +-+ +-+ + + +-+ +
|           |       | |     |   |     |   | |       | |         | | | |       |       |   |   |     |
+-+-+-+-+-+-+-+-+-+-+-+-+-+-+-+-+-+-+-+-+-+-+-+-+-+-+-+-+-+-+-+-+-+-+-+-+-+-+-+-+-+-+-+-+-+-+-+-+-+-+
