30
30
+-+-+-+-+-+-+-+-+-+-+-+-+-+-+-+-+-+-+-+-+-+-+-+-+-+-+-+-+-+-+
| |         |   |   | | |       |   |       | |   |     |   |
+ +-+-+ +-+-+ +-+ +-+ + +-+-+-+ +-+ +-+-+-+ + + +-+-+ +-+-+ +
|       |         |   |   |   | |   |   | |     |   |     | |
+-+-+ + +-+-+-+ + +-+ +-+ +-+ + +-+ + + + + + +-+-+ +-+-+ + +
| |   | |     | |     |       |   |   |     | |     |       |
+ +-+ + + +-+-+-+ + +-+ + +-+-+ +-+ +-+-+ +-+-+-+ + + + +-+-+
|     | |         |     |   |   |       | | |   | |   | |   |
+-+-+ + + + + + + + +-+ + +-+ +-+ +-+ +-+ + +-+ +-+ + +-+ +-+
| |   |   | | | | |   | |   |     |   |   |   | |   | | |   |
+ +-+ + + + + +-+-+-+-+ +-+-+-+-+ +-+-+ +-+ + + + + + + +-+ +
|   | | | | |     |   |   | |   |     | | | |   | | |       |
+ + +-+-+-+ + +-+-+ +-+ + + + + + + +-+ + +-+ +-+-+ +-+ +-+ +
| |   |     | | |     | |     |   | |         |       | |   |
+-+-+ +-+ + +-+ + +-+-+-+-+ +-+-+ + +-+-+-+ +-+ +-+ +-+-+-+ +
| |       | | |             |     | |     |     | | |     | |
+ + + +-+ + + +-+-+ + +-+-+ + +-+ + + + + +-+ +-+ +-+ + +-+-+
|   | |   | | | | | | | | | | |   | | | |           | |     |
+ +-+-+ + +-+ + + +-+ + + +-+ +-+-+ + +-+ +-+-+ + + + +-+-+-+
|   | | | |     |       | |   | | | | |   |     | |         |
+ +-+ +-+-+ +-+-+-+-+ +-+ + + + + +-+-+-+-+ +-+-+-+ + + +-+ +
| |       |     |       |   | |           | |   | | | | |   |
+-+-+ +-+-+-+ +-+ +-+-+-+ +-+ + +-+-+-+-+-+ + + + +-+-+-+-+ +
|         | | | |   |   | |   |       | | |   | |     | |   |
+ +-+-+ +-+ + + + +-+ + + +-+ + +-+-+-+ + + +-+-+-+ + + +-+-+
| |   |           | | | | |     | | |   |   |   |   |     | |
+-+-+ + +-+ +-+-+ + + +-+-+ + +-+ + +-+ +-+ +-+ +-+ +-+-+ + +
|   | |   |   |   |   | |   | | |   | |   |   | |     |     |
+ + + +-+-+-+-+ +-+-+ + +-+-+ + + +-+ + +-+-+-+ +-+-+ +-+-+ +
| |   |           |   |   | |     | | |                 |   |
+ + +-+-+-+-+ + +-+ +-+-+ + +-+ +-+ + + +-+-+-+ +-+-+-+-+-+ +
| |   | | |   | |     | | |     |     | | |       |   | |   |
+-+ +-+ + +-+-+-+ +-+-+ + +-+ + +-+ +-+-+ + +-+-+-+ +-+ +-+ +
| |     |     |     |   |     | |     |   |           | | | |
+ +-+ + + +-+ +-+ + + +-+-+-+ +-+-+-+ + + + + + +-+-+-+ + + +
| |   |   |   | | | |     |   |     |   |   | |       |   | |
+ +-+-+ + +-+ + +-+ +-+ +-+ +-+ + +-+ + +-+ +-+-+ +-+-+-+ +-+
|     | | |       |     |       | |   | |   |         |     |
+ + + +-+-+ + +-+-+ + +-+ + +-+-+ + +-+-+-+ + + + +-+-+ +-+ +
| | |   |   | | |   |     | | |       | | | | | |   | |   | |
+ +-+-+-+-+-+ + +-+-+-+-+ +-+ +-+-+ +-+ + +-+-+ +-+-+ + +-+ +
| | | |   | |   | |   |     |         | |   | |     | | |   |
+ + + +-+ + + +-+ +-+ + + +-+ +-+ + +-+ + +-+ +-+ + + + + +-+
| | | | |   | |         | | |   | | |   |     | | | |   |   |
+ + + + +-+ + +-+ + +-+-+ + +-+ +-+ + +-+ +-+ + +-+ + +-+-+-+
|     | |   |     |     | | |   |     |   | |   |   | |   | |
+ +-+ + + +-+ +-+ +-+-+ +-+ +-+-+-+ +-+ +-+ +-+-+ + + + +-+ +
| |           | | | |   |   |     | | |         | |       | |
+-+ +-+ +-+ + + + + + +-+ +-+ +-+-+ + +-+ + +-+ + +-+ +-+ + +
|   |   |   | |     | |   |   |   |   |   | | | | | | | |   |
+-+ + +-+ + +-+ + + +-+-+ + +-+-+ +-+ +-+-+-+ + + + +-+ + +-+
|   | | | |   | | |       |   |     |   |     |     | |     |
+-+-+-+ +-+-+-+-+-+ +-+ +-+ +-+-+-+ +-+ +-+-+ +-+-+-+ + +-+ +
|       |           |     |   |           |   |   |   | |   |
+ +-+ +-+-+ +-+-+-+-+-+ + +-+ + +-+ +-+-+ + + +-+ +-+ + +-+ +
| |       | |     | |   | | | | | | | |     | |     | |   | |
+ +-+ +-+-+-+ + + + +-+ + + + +-+ +-+ +-+-+ +-+ + + + +-+-+ +
|   |   |     | |       |           |       |   | | |       |
+ +-+-+ +-+ + +-+-+ +-+ + + +-+ +-+-+-+-+ + +-+ + +-+-+-+ +-+
|   |       | |       | | |   |   |       |     |   |       |
+-+-+-+-+-+-+-+-+-+-+-+-+-+-+-+-+-+-+-+-+-+-+-+-+-+-+-+-+-+-+
