6
4
+-+-+-+-+-+-+
| |   |   | |
+ +-+ +-+ + +
| |   | |   |
+ + +-+ +-+ +
|         | |
+ +-+ + + + +
| |   | |   |
+-+-+-+-+-+-+
