10
10
+-+-+-+-+-+-+-+-+-+-+
|   | |       | |   |
+-+ + + + +-+ + + +-+
| | |   | |   | |   |
+ + +-+ +-+-+-+ + + +
| |   |   |       | |
+ + + +-+ + +-+-+-+ +
|   | | |   |   |   |
+-+-+ + +-+ + +-+-+-+
|   |     |     |   |
+-+ + +-+ +-+ + + + +
|   |   |     |   | |
+-+ +-+ + +-+ +-+-+-+
|       |   | |     |
+-+ +-+ +-+ + + +-+-+
|     | |   | |     |
+-+-+ +-+-+ +-+ + + +
| |       |     | | |
+ + + + + +-+-+-+-+ +
|   | | |     |     |
+-+-+-+-+-+-+-+-+-+-+
