30
30
+-+-+-+-+-+-+-+-+-+-+-+-+-+-+-+-+-+-+-+-+-+-+-+-+-+-+-+-+-+-+
|     |   |     |     |   | | | |       | | | |         |   |
+ + +-+ +-+ + +-+ + + + + + + + +-+-+-+ + + + +-+-+ +-+ +-+ +
| |     |   |   | | |   |     | |     |       |   | |       |
+ +-+ + +-+-+-+ +-+-+ + +-+ +-+ + + +-+ +-+ +-+-+ + +-+-+ +-+
|   | | | | |         | | | |   | |     |       |     |     |
+ +-+-+ + + + +-+-+ +-+ + +-+-+ + + + + +-+-+-+ + + +-+-+ + +
| |     | | |     | | |   |     | | | | | |   |   | |   | | |
+ +-+-+ + + +-+ +-+-+ + + +-+ +-+ + + +-+ + + + +-+ + +-+-+ +
|   |     | |   |       | | |     | | |   | |     |       | |
+-+-+-+-+ + + + +-+-+ +-+-+ +-+-+-+ + +-+ +-+-+-+-+-+ + +-+ +
|         |   | | |       |   | |   | |     |   |     | |   |
+-+-+-+ +-+-+ +-+ + + +-+ +-+ + + +-+ +-+ +-+-+ +-+-+ +-+-+ +
|   | |   |       | | | |   | | |   |   |   | | |   |   | | |
+-+ + +-+ + +-+-+ + +-+ +-+ + + +-+-+ + + +-+ + +-+ + +-+ + +
|       |     | | |     | |           | | |             |   |
+-+ +-+-+-+ +-+ +-+-+-+-+ + +-+ +-+-+ + + +-+ +-+-+-+-+-+-+-+
|   |     | |   | |       |   | |     |     |         | |   |
+ + + +-+-+-+-+ + +-+ +-+ +-+ + + +-+-+ +-+ +-+-+ + + + +-+ +
| |         |   |   | | | | | | | |   |   |     | | | |     |
+-+ +-+ +-+ + + + + + + +-+ + + +-+ + +-+-+ +-+-+ + + + +-+-+
|   |   |     | | |         | | | | | | |     | | | |   |   |
+-+ +-+-+ +-+-+-+-+ +-+-+-+-+-+ + + +-+ +-+ + + + +-+ +-+-+ +
| |     |     | | |   |               | | | | |     |     | |
+ +-+ + + +-+-+ + + +-+-+-+ +-+ +-+ +-+ + +-+-+-+ + +-+ + + +
|   | | |       | | |   | | | | |   | | | |       |   | |   |
+-+ +-+-+ +-+-+ + + + + + + + +-+ +-+ + + + + +-+-+-+-+-+-+-+
| |       |   |   | | | | | |   | |         | | |           |
+ +-+ +-+-+-+ + + + +-+ + + +-+ +-+-+-+-+-+-+ + + +-+-+-+ + +
|         | |   |             |   |   | | |             | | |
+ + + +-+ + + +-+-+ + + +-+ + +-+ + + + + +-+ +-+ +-+-+-+-+-+
| | | |     | |   | | |   | | |     |         | |   |     | |
+-+ + +-+-+ + +-+ +-+ +-+-+-+ +-+ +-+ +-+ + + + + +-+-+ +-+ +
| | | |   | | |       |   |   |   |   |   | |   |     |     |
+ + + + +-+ +-+ +-+-+-+ + +-+-+ +-+-+-+-+ +-+ + + +-+ + +-+-+
| | |   |   | | |     | |         |   | | |   | |   | |   | |
+ +-+-+-+ +-+ +-+-+ +-+-+ +-+ +-+ + +-+ +-+-+-+ +-+ +-+ +-+ +
|           | |       | | | | |       |       |   |         |
+ +-+-+-+ + + + +-+ +-+ + + +-+-+-+-+ +-+ +-+ +-+-+-+-+-+ + +
| |   | | | |     |         | |   | | |   |   |     |   | | |
+-+-+ + + +-+-+ + +-+ + +-+ + + +-+ +-+ +-+-+ + + + +-+ + +-+
|       |     | |   | |   | |           | |   | | | |   |   |
+ + + +-+ + +-+ + + +-+-+-+ + +-+-+ +-+ + +-+-+ +-+ + +-+ + +
| | |     | | | | |   | | | | |     |   |   | | |     | | | |
+ +-+-+-+-+ + +-+ +-+-+ + +-+-+ + +-+ + +-+ + + +-+-+-+ +-+-+
|   | | | | |   | | |   |   |   | | | |       |   |     |   |
+ + + + + +-+ +-+ + +-+ + + +-+-+ + +-+-+-+ +-+-+ + +-+-+ + +
| |       |           | | |       | | |     |       |   | | |
+-+-+-+ +-+-+-+-+ +-+ + + +-+-+-+ + + + +-+-+ +-+-+-+-+ + + +
| |   |   |   |   | |     |   |     |     |   | | |   | | | |
+ + +-+ +-+ + +-+ + + + + + +-+ +-+-+-+ +-+ +-+ + +-+ + + + +
| | |   | | | |   | | | | |     |   | |               |   | |
+ + + +-+ + + + +-+ +-+ +-+-+ +-+ +-+ +-+-+-+-+ +-+ + +-+ +-+
|   | |     |     |       |     |   |         | |   |       |
+ +-+-+ +-+ +-+-+-+ +-+-+-+ +-+-+ + +-+-+-+ +-+-+ +-+-+-+ +-+
|   | | |   | |           |   |   |   |   |       |   | | | |
+ +-+ +-+-+ + + + + +-+-+-+-+-+-+ +-+-+-+ +-+ +-+-+-+ + + + +
|     |   | |   | |     | | |                   |           |
+ +-+ + +-+-+-+ +-+ +-+-+ + +-+ +-+ +-+ + +-+-+ +-+-+-+ + + +
| |               |           | |   |   |     |     |   | | |
+-+-+-+-+-+-+-+-+-+-+-+-+-+-+-+-+-+-+-+-+-+-+-+-+-+-+-+-+-+-+
