40
40
+-+-+-+-+-+-+-+-+-+-+-+-+-+-+-+-+-+-+-+-+-+-+-+-+-+-+-+-+-+-+-+-+-+-+-+-+-+-+-+-+
|           | |     |   | |       |       | |       | |           |   | |   |   |
+ + + + +-+ + + + +-+-+ + + +-+-+ +-+-+ + + +-+-+ +-+ + + +-+-+-+-+ + + + +-+ +-+
| | | | |     | |     |       |   |     | |       | | | | |   | |   | |         |
+ +-+ +-+-+ + + +-+-+ +-+ +-+ +-+-+-+ + + +-+-+-+ + + +-+ +-+ + + + +-+ +-+ +-+-+
| | |   |   |       | | |   | |   | | | |             | | |       |       |     |
+ + +-+ + +-+-+-+-+ +-+ + +-+-+ +-+ +-+ +-+ + +-+ + +-+ + +-+ + +-+ +-+-+-+ +-+ +
|   | | | |   | |   |     |   |     |   | | | |   | |       | | |         | |   |
+-+ + + + + +-+ +-+-+-+ + + +-+-+-+ + +-+ + + +-+-+ +-+-+-+ + + +-+-+-+ +-+-+-+ +
|   |   | |   |         |     | | | |   |   |   |   | |       | |     | |       |
+ + +-+ +-+ + + +-+-+-+ + +-+-+ + + + +-+-+-+ + +-+ + + +-+-+-+ + +-+-+ +-+-+ +-+
| | |       |     |     | | |   |     |       | |   | |   | |         | |   |   |
+-+ +-+ +-+-+-+-+-+-+-+ +-+ + + + +-+-+-+-+-+-+-+ +-+ +-+ + +-+-+ +-+-+ + +-+-+-+
|   |   | |     | |         | | | |   | | |     | |   |     | |       |     | | |
+-+-+-+ + + + + + +-+-+ + + + + + + +-+ + +-+ +-+ +-+ +-+-+ + +-+ +-+ +-+-+ + + +
| | | | |   | |   |     | | | | |     |     |       |   |   |   |   |   |   |   |
+ + + + +-+ + + +-+ +-+ +-+-+ + + +-+-+-+ +-+ + +-+-+ +-+-+-+ +-+ +-+ +-+-+ + +-+
|   |   | | | | | |   |   | | |       |     | |           | | |   |     |     | |
+-+ +-+ + + + +-+ + +-+ +-+ +-+-+-+-+ + + +-+-+-+-+ + + +-+ + + +-+-+-+ + + +-+ +
|       |   |   |     |   |       |     | |         | |       |       | | |     |
+ +-+ + + + + +-+ +-+ + + + +-+-+ +-+-+-+ + +-+ +-+-+ +-+ +-+-+-+ +-+ +-+-+-+-+-+
| |   |   | | |   | | | |     |       |   |   |     |   | |         |   |   |   |
+ +-+-+ +-+-+-+-+-+ + + + +-+-+-+ + +-+-+-+ +-+-+-+-+-+-+-+-+-+-+ +-+ +-+-+ + +-+
| | |   |     |     | | | |     | |   | |       | | | |     |   | | |     |     |
+-+ +-+ + +-+ + + + +-+-+-+-+ +-+-+ + + + +-+-+ + + + + +-+ + +-+-+ + +-+ + +-+ +
| |   |   | | | | |   |       |     | | |   |       |   |   |     |     | |   | |
+ + +-+-+ + + +-+ +-+ +-+ + +-+-+ + + + + +-+ +-+-+ + +-+-+-+-+ + +-+-+-+ +-+ +-+
|     |     |   | | | |   |   | | | | | |   | |     |       |   | | |     | |   |
+-+ +-+ + +-+ +-+-+ + + +-+ +-+ +-+ +-+ +-+-+-+-+ +-+ + +-+-+-+-+ + +-+ +-+ +-+ +
| | | | |   |   |   | |   |     | |         |   |   | | |     |       | | |   | |
+ + + + +-+-+ +-+ +-+ +-+-+ +-+ + + + +-+-+ + + + +-+-+ +-+ + + + + +-+ + + +-+ +
| |   | |   | |       |     | |     | | |     | |   | |   | |   | |         |   |
+ +-+ +-+ +-+ +-+ + +-+-+ +-+ +-+-+-+ + + +-+ +-+-+ + +-+ +-+-+ +-+-+ +-+-+ +-+ +
|         | |     | |   | |   | | |   | |   | | |     |     |       |     |   | |
+ +-+-+ +-+ + +-+ +-+-+ + + + + + +-+ + + +-+ + + + +-+ +-+ + +-+-+-+ + +-+ +-+ +
| | |   |   | | |   | |   | |   |   | |   | |   | |     | |   |   |   |   | |   |
+-+ + +-+ +-+-+ +-+-+ +-+ +-+-+ +-+ +-+ +-+ +-+ + +-+-+-+ +-+ + +-+-+-+-+ +-+-+ +
|         |       | |       |                 | | |   |     |         | |   |   |
+ +-+-+ + + + +-+ + + +-+-+ +-+ + +-+-+ +-+ +-+ + +-+ + +-+ + +-+ +-+-+ + +-+ + +
| |     | | | |     | | |     | |     |   | | |     |     | | |   |           | |
+-+-+-+ +-+-+ +-+ + +-+ +-+ +-+-+ + +-+-+ +-+ +-+-+-+ +-+ +-+-+-+-+-+-+-+-+-+-+ +
|     |     | | | | |         |   | |     | | |   | | |       |     |   | | |   |
+-+-+ + + + +-+ +-+ +-+ +-+ +-+-+-+ +-+-+-+ + +-+ + + +-+-+-+ + +-+-+-+ + + +-+-+
|   |   | | |       |     |     |   |   |       | | |   |   | |   |     | |     |
+-+ + +-+-+-+-+ +-+ + +-+-+ +-+ + + + +-+ + +-+ + + +-+-+ +-+ +-+ + + + + +-+ +-+
| | |   |     | | | |     | | | | |       |   | | |   |       |     | | |       |
+ + +-+ + + +-+ + +-+-+-+ + + + +-+-+ + + +-+-+ + + + + + +-+ +-+ + +-+ + +-+-+ +
|     |   |               | |   | | | | | | | |     |   | |   |   | |       | | |
+-+ + + + + +-+-+-+-+ + + +-+ +-+ + + +-+ + + +-+-+-+-+-+ +-+-+-+-+-+-+ + + + +-+
|   |   | |   | | |   | | |   |       |   | |   |           |   |   |   | |     |
+-+-+-+ +-+-+-+ + +-+ +-+ +-+-+-+ +-+ +-+ + + +-+-+ +-+ + +-+ + + +-+-+-+-+ +-+ +
|   |   |   | |   | |   |     |   |   |       | |   | | |     |         |   | | |
+ + + +-+-+ + +-+ + + + +-+ +-+-+-+-+-+-+ +-+-+ + +-+ + +-+-+ +-+-+ +-+ + +-+ +-+
| | | |   |           | |   | |       | |   |   | |       | | |     | | |       |
+ + +-+-+ + +-+-+-+-+ +-+-+ + + +-+ + + + +-+-+ + +-+ +-+ + +-+-+ +-+ + + +-+-+-+
| |   | |       |     | |     | |   |   | | |   | |   |     |   | | |       |   |
+ +-+-+ +-+ +-+ + + +-+ + +-+-+-+ +-+ +-+-+ + +-+-+-+ +-+-+ +-+ + + + + +-+ + + +
|             | | | |   | |         |   |   |   | | | | | |   |     | | | |   | |
+-+-+ + +-+-+ +-+-+ + + +-+-+-+ +-+ +-+ +-+ + +-+ + + + + +-+-+-+ +-+ +-+ +-+-+-+
|   | | | |       |   |     |     |   |           | | |         | |       | |   |
+-+ +-+-+ +-+-+-+-+ +-+ +-+ +-+ +-+ +-+-+ +-+-+-+-+ + + + +-+ +-+-+ +-+ + + + + +
|   |   |     |       | |     | |     | |   | |       | | |           | |     | |
+ + + +-+ +-+ +-+-+ +-+-+ +-+ + +-+-+ + +-+ + +-+-+-+ +-+-+-+ +-+-+-+ +-+ +-+-+ +
| |     | | | |   | |       |   |       | |   |   | | |   |         |   |   | | |
+ + +-+ + + + +-+ +-+-+ +-+-+ + +-+-+ + + + +-+ + + + +-+ +-+ +-+-+-+-+-+-+ + +-+
| | |     | | |       | |     | |   | | |       |   |   |       |     |     |   |
+-+-+ +-+ + +-+-+ + + + +-+-+ +-+ + +-+ +-+ +-+-+-+ +-+ + + +-+-+-+ +-+ + +-+ + +
| |   |   | |   | | |       |   | |   |   | |     | |   | |   |   |     |   | | |
+ +-+-+ +-+ + +-+-+ +-+-+-+ +-+-+-+-+ +-+-+ + +-+-+ + +-+-+ +-+ + +-+-+-+-+ + +-+
|       |     |   |     |   |           | |     |   | | |   |   | |   |       | |
+ + +-+ + +-+-+-+ +-+ + +-+ + +-+-+ +-+-+ + +-+ + + + + +-+-+-+-+ +-+ +-+-+ + + +
| | | | |         |   | |         |     | |   | | | | | | |         |       |   |
+-+ + + +-+-+-+ +-+ + +-+-+ +-+ +-+-+-+ + + +-+-+-+ +-+ + + +-+-+-+ +-+-+ + +-+ +
|     |     |   |   | | |   |     | | |   | |   |   |   | | | |     | | | | | | |
+-+ +-+-+-+-+ +-+ +-+-+ + +-+ +-+-+ + + +-+-+-+ +-+-+ + + + + +-+ + + + +-+ + + +
|     |         |   | |     |   |     |   |       |   | |   |   | | | | | |   | |
+ + +-+-+ +-+ + + +-+ +-+-+ +-+-+-+-+ + +-+-+ +-+-+ +-+ +-+ +-+ + +-+ + + + +-+ +
| |     | |   |   |         | |             |     | | |       |           | |   |
+-+-+ + + + +-+ +-+-+ + +-+ + + +-+-+ + +-+ + +-+-+ + +-+-+ +-+ + + +-+ +-+ +-+ +
|     |   | |     |   |   |   |     | |   |             |     | | |   | |     | |
+-+-+-+-+-+-+-+-+-+-+-+-+-+-+-+-+-+-+-+-+-+-+-+-+-+-+-+-+-+-+-+-+-+-+-+-+-+-+-+-+
