5
5
+-+-+-+-+-+
|   |     |
+-+ +-+ +-+
|       | |
+-+ +-+-+ +
|         |
+ +-+-+-+-+
|     | | |
+-+-+ + + +
|         |
+-+-+-+-+-+
