15
12
+-+-+-+-+-+-+-+-+-+-+-+-+-+-+-+
|   | |   | |   | |       |   |
+-+ + +-+ + + + + +-+-+-+ + +-+
|             | |   |     |   |
+-+ +-+-+-+-+-+ + + +-+ +-+ +-+
|       |       | | |       | |
+ +-+ + +-+-+-+-+ +-+-+-+ + + +
| | | |           | | | | |   |
+-+ +-+ + + + +-+-+ + + + +-+-+
|       | | | |     | |       |
+ +-+-+ + +-+-+-+-+ + + +-+-+ +
| | |   |   |       |     |   |
+ + +-+ +-+ + +-+-+-+ +-+ +-+ +
|   |   | |           | |   | |
+ +-+ +-+ + +-+ + +-+-+ + +-+-+
| |   |     |   |   |   | | | |
+ +-+-+-+ +-+ + +-+ + +-+ + + +
|   |   | | | | |       |     |
+-+-+-+ +-+ + + + +-+ + + +-+-+
|         |   | | | | | |   | |
+-+ +-+-+ + +-+-+-+ + +-+-+ + +
|     |     |       |   | |   |
+ + + +-+ +-+-+-+-+ +-+ + + +-+
| | |   |             | |     |
+-+-+-+-+-+-+-+-+-+-+-+-+-+-+-+
