5
5
+-+-+-+-+-+
| | |     |
+ + + +-+ +
|     | | |
+-+-+ + +-+
|         |
+ + +-+-+-+
| |       |
+ +-+ +-+-+
| |       |
+-+-+-+-+-+
