20
20
+-+-+-+-+-+-+-+-+-+-+-+-+-+-+-+-+-+-+-+-+
|     |       | |             |         |
+-+-+ + + +-+ + +-+ + +-+-+-+ + + +-+-+-+
| |     | |   |   | |     | |   |       |
+ +-+ +-+-+ +-+-+ + + +-+-+ + + +-+-+-+-+
|   |     | | | |   | |       |     |   |
+-+ + +-+-+ + + + + +-+-+ +-+ +-+-+-+ +-+
|         |     | |   | |   | |         |
+-+-+ +-+-+-+-+ +-+-+-+ +-+-+ + + + +-+-+
|   |   |         |           | | |     |
+-+ +-+-+-+-+ + +-+-+-+-+ + +-+-+ +-+-+-+
|       |     | | |     | | |   |     | |
+-+-+-+ + +-+-+ + + +-+ + + + + +-+ +-+ +
| | |         |   |   |   |   | |   |   |
+ + + + +-+-+-+ +-+-+ +-+-+-+-+ + + + + +
|     | |       |     |     |     |   | |
+ +-+-+ +-+ + + +-+ +-+ + +-+-+-+ +-+-+ +
|   | | | | | | |   | | | | |         | |
+-+-+ + + + +-+-+ +-+ + +-+ + +-+-+ + + +
|         | |   | |     |   |     | | | |
+ +-+-+-+ +-+-+ + +-+-+ +-+ + +-+-+-+-+-+
|   |     | | |   |   |     |       |   |
+ +-+-+-+ + + + +-+-+ + + +-+-+-+ + + +-+
|   | | |           | | | |   |   |   | |
+ +-+ + +-+-+ + + + + + +-+ +-+ + +-+-+ +
|       |   | | | |     |       |       |
+-+ +-+ + +-+ +-+ +-+ + +-+ + +-+-+-+-+-+
| | |       | |   |   | |   | |         |
+ + +-+ +-+ +-+ + +-+-+ +-+ +-+-+-+ + +-+
| |   | |   |   | | | | |   | |     | | |
+ +-+ +-+ + + +-+ + + + + +-+ + +-+-+ + +
|       | | |   | | |   |     | | | | | |
+-+ + + +-+-+ + + + + + +-+-+ + + + +-+ +
|   | |   |   | |   | | |       | | |   |
+ + + +-+-+-+-+ +-+-+-+-+ + +-+-+ + + +-+
| | |   |   |   |   | |   |   |         |
+-+ +-+ + + +-+ + + + + +-+-+-+-+-+ +-+ +
| |   |   | |     | | | | |         |   |
+ +-+-+-+-+ +-+-+-+ + + + +-+ +-+ +-+ +-+
|             |       |         | |     |
+-+-+-+-+-+-+-+-+-+-+-+-+-+-+-+-+-+-+-+-+
