20
20
+-+-+-+-+-+-+-+-+-+-+-+-+-+-+-+-+-+-+-+-+
| | |     | | |         |     |     |   |
+ + +-+-+ + + +-+-+ + +-+ +-+ + +-+-+-+ +
|     |   |   |     |     |   |         |
+ + +-+ + + +-+ +-+-+-+ + +-+ + + +-+-+-+
| |   | | |   |       | | | | | |   |   |
+-+ +-+-+ + +-+-+ +-+ + + + +-+-+ + + +-+
| |                 | | |       | |   | |
+ +-+ +-+ +-+ + +-+ +-+-+-+-+-+ + +-+ + +
| |   |     | |   | | |   |       |   | |
+ + +-+-+-+ + + + + + + +-+-+ +-+-+-+-+ +
|   |   | | | | | |     | |     |   |   |
+-+ + +-+ +-+ +-+-+-+ + + +-+-+ + +-+ +-+
|   | | |   | | |     |   |   |         |
+ + + + +-+ +-+ +-+ + +-+-+ +-+-+-+ +-+ +
| |   |       |     |         |       | |
+-+-+-+ +-+-+-+ + +-+ +-+ +-+-+-+ +-+-+ +
| | |   |   |   | |   | |     | |   | | |
+ + + +-+ +-+ + +-+ +-+ + + +-+ +-+ + + +
|       |     |   |     | | |   | | |   |
+ +-+-+ + +-+-+-+ + +-+-+-+ + + + +-+-+-+
| |         | |   |   |   |   | | |     |
+ +-+-+ +-+-+ + +-+ +-+ + +-+ +-+ + + +-+
|   |     |       |     | | |     | |   |
+-+ +-+-+-+ +-+ + + + +-+-+ +-+-+-+-+ +-+
|     |   |   | | | |             | | | |
+-+ +-+ + +-+-+-+-+ +-+-+ + +-+-+ + + + +
|   |   |   |   |   | | | | |     |   | |
+ + +-+ + + + +-+-+-+ + +-+-+-+-+ +-+ + +
| | | | | |         |   |   | |   |     |
+ +-+ +-+-+-+ + +-+-+-+ + +-+ + +-+-+ +-+
| |   |   |   |     |         |   |     |
+ +-+ + + + + + +-+-+ +-+ +-+-+ +-+-+-+ +
| | |   | | | |     |   | |           | |
+ + + +-+ + + +-+-+-+-+ +-+-+-+ + +-+ + +
| | |   |   | |   |     |   | | | |     |
+ + +-+-+ + + + +-+ +-+ + +-+ +-+-+ + +-+
|   |     | |   | | |   |     |   | |   |
+-+ + + +-+ +-+ + +-+ +-+-+ + +-+ +-+ +-+
|     | |     | |           |           |
+-+-+-+-+-+-+-+-+-+-+-+-+-+-+-+-+-+-+-+-+
