5
5
+-+-+-+-+-+
|     |   |
+-+-+ +-+ +
| | |   | |
+ + +-+ + +
|   |     |
+ + +-+ +-+
| |   |   |
+ + + + + +
| | |   | |
+-+-+-+-+-+
