10
10
+-+-+-+-+-+-+-+-+-+-+
|           |   | | |
+-+ +-+-+-+ +-+ + + +
|   |   |           |
+-+ +-+ +-+-+ +-+-+ +
|   | | |     |     |
+-+-+ + +-+ +-+-+-+-+
|       |   |       |
+-+-+-+ +-+ + + +-+ +
|   |         | | | |
+-+ +-+-+-+ +-+-+ + +
|       |       |   |
+ +-+-+-+-+-+-+-+ +-+
|     | | | |     | |
+-+ +-+ + + +-+ + + +
|         | |   |   |
+ +-+-+ +-+ + +-+-+-+
| |         |   |   |
+ +-+ + +-+-+-+ + + +
| |   |           | |
+-+-+-+-+-+-+-+-+-+-+
