30
30
+-+-+-+-+-+-+-+-+-+-+-+-+-+-+-+-+-+-+-+-+-+-+-+-+-+-+-+-+-+-+
|       |         |   |     |           | | | |       |     |
+ + +-+ + +-+ + +-+ +-+ + +-+-+ +-+-+-+-+ + + +-+-+ + +-+-+ +
| | |   |   | |         |     |     | | |         | | |     |
+-+-+ +-+-+ + +-+-+ +-+-+-+-+ + +-+-+ + + +-+ +-+-+ +-+ + +-+
|         | | | |   | | | |     |   |       | | | |     |   |
+-+-+ + +-+-+-+ + + + + + +-+-+ + +-+-+-+ +-+-+ + + +-+ + +-+
| | | | | |     | |     |         |       | |   | | | | |   |
+ + + + + + +-+ + +-+ +-+ +-+-+-+-+ +-+ +-+ + +-+ + + +-+-+-+
|   | |   |   |   |   |   | |   |     | | |       |     |   |
+-+ +-+ +-+ +-+-+-+ +-+-+-+ +-+ + +-+ +-+ + +-+-+ +-+-+ +-+ +
|       |         |   |     |   | |   |   | |   |   |   |   |
+-+ + +-+-+-+ + +-+-+-+-+ + +-+ +-+-+ + +-+ + +-+ + +-+ +-+ +
|   |   | |   | |     |   | | |       | | | | | | |         |
+-+-+-+ + +-+ +-+-+ +-+ +-+-+ + +-+-+ + + +-+ + + + +-+ +-+ +
|     |       | | |     |   |   | | |   |         |   | |   |
+ + +-+ +-+ + + + +-+-+ +-+ +-+ + + + +-+-+-+-+ +-+-+ + + + +
| |       | |     | |         |     | | |   |       | | | | |
+-+ +-+-+ +-+-+-+ + + + +-+ +-+-+-+ +-+ + +-+ +-+-+-+ +-+-+ +
| | |       |   | |   | | |   | | |         | |       |     |
+ +-+ +-+ +-+ +-+-+-+ +-+ +-+-+ + +-+-+ +-+ +-+-+-+-+ +-+-+ +
| | |   |   |     |       | | |   |       |   |   | | |   | |
+ + + +-+-+-+ + + + + +-+-+ + +-+ + +-+-+-+-+-+ +-+ + + +-+-+
|         |   | |   |   | | |           |         |   |   | |
+-+ + +-+ +-+-+-+ +-+ + + + + +-+-+-+-+-+-+ + +-+ + + +-+ + +
| | | |         | |   | |       |   |     | |   | | |   |   |
+ +-+-+-+ +-+-+ + +-+-+-+-+-+ + + + +-+-+ +-+ +-+-+ +-+-+-+ +
|   | |       | |             | | | |     | |         |   | |
+ +-+ +-+-+-+-+ +-+ +-+-+-+ +-+ +-+ + +-+-+ +-+-+ +-+-+ +-+ +
|   |           | |   |       |         |           |   | | |
+-+ + +-+-+ +-+ + + +-+-+-+ +-+-+ + +-+-+ +-+-+-+ +-+ +-+ + +
|   | |     | |     |   | | | |   | |     | |           |   |
+-+ +-+-+-+ + +-+-+ + +-+ + + + +-+ + +-+ + + +-+-+ +-+-+-+ +
|   |   |   | |         |     | |   | | | |   |     | |     |
+-+ + +-+-+ + + +-+-+-+ + + +-+-+-+ + + + + +-+ +-+ + +-+-+ +
|   |   | | |   |     | | |   |       | | |   |   |     | | |
+-+ + + + +-+-+-+ +-+-+ + + +-+-+-+-+ + +-+-+ +-+-+ +-+ + + +
| |   |           |   | | |       | |   |   | | |     |   | |
+ +-+ + +-+-+-+ +-+-+ +-+-+ +-+-+-+ +-+-+ +-+-+ + + + +-+-+ +
| |   | | |   |   | |         |         | |       | | |     |
+ + +-+-+ +-+ +-+ + + +-+-+ +-+-+-+-+-+ + +-+-+-+-+-+ + + +-+
|   |       | |     | | |   | |           | |           |   |
+ + +-+ +-+ + + + + + + + + + + + +-+-+-+ + +-+ +-+-+-+ +-+-+
| | |   | |   | | |     | |   | | | | |     |         | |   |
+ + + + + + + + +-+-+-+-+-+ + +-+-+ + +-+ + +-+ + + + +-+ +-+
| |   | |   | | |     |     |     |     | |   | | | |       |
+ +-+ + + + +-+-+-+ +-+-+-+-+-+-+ + + +-+-+-+ +-+-+-+-+ +-+-+
| |   | | |     | | | |     |   | | |   |       |     | |   |
+-+-+-+ +-+-+ + + + + + +-+ +-+ +-+ +-+ + +-+-+-+ +-+ + + +-+
|   |   |     |     | | |     |     |       | | | | |       |
+ + + + +-+-+-+ +-+-+ +-+-+ +-+ +-+ +-+-+-+-+ + +-+ + + + +-+
| | | |   |       |       | |   |   |   |     |       | | | |
+ +-+ +-+-+ + +-+-+-+ +-+ + + + + + + +-+-+-+ +-+ +-+ + +-+ +
|     |   | | |   |   |       | | |   | |           | | | | |
+ +-+ + +-+ +-+-+ +-+-+-+ + + +-+ + + + + + +-+ + + + +-+ + +
|   |     |   | | | |   | | | | | | |   | | |   | | |       |
+ +-+ +-+ +-+ + + + + + +-+-+ + +-+-+ +-+-+ +-+ +-+-+-+ + +-+
| |   | | |   | |     |     | |   |           |       | | | |
+-+ + + + + +-+ + + +-+ +-+-+ +-+ + + +-+ +-+ +-+ +-+-+-+-+ +
|   |   | |       |   | |         | |   |   |   |           |
+-+-+-+-+-+-+-+-+-+-+-+-+-+-+-+-+-+-+-+-+-+-+-+-+-+-+-+-+-+-+
