5
5
+-+-+-+-+-+
|     |   |
+-+-+ + +-+
|   | |   |
+-+ + +-+ +
|   |   | |
+-+ + +-+ +
|     |   |
+ + + + +-+
| | |     |
+-+-+-+-+-+
