10
10
+-+-+-+-+-+-+-+-+-+-+
|     | |   |       |
+-+-+ + +-+ +-+-+-+ +
|     |   | |       |
+-+-+ +-+ + +-+-+-+ +
| | |   |   |       |
+ + + +-+ + +-+ +-+-+
|         |         |
+-+-+-+ + +-+-+ +-+ +
| | |   | |   | |   |
+ + +-+ +-+ +-+-+-+-+
| | | |     |       |
+ + + + +-+-+ +-+-+ +
|     |         | | |
+ +-+ + + + +-+-+ + +
| |   | | |   | | | |
+ +-+ +-+-+-+ + + + +
| |     |       | | |
+ +-+-+ +-+-+ + + +-+
|   |         |     |
+-+-+-+-+-+-+-+-+-+-+
