20
20
+-+-+-+-+-+-+-+-+-+-+-+-+-+-+-+-+-+-+-+-+
|     | |   | |   |   | |   |   |   |   |
+ + + + + +-+ + +-+ +-+ +-+ + +-+ +-+ +-+
| | |   |             |           |   | |
+-+-+ +-+-+-+ + + +-+-+ +-+ +-+ +-+-+ + +
|       |   | | | |       | |     |     |
+ +-+-+-+-+ +-+-+ + +-+-+-+-+-+-+ + +-+-+
| |         | |   | | |         | |     |
+ + +-+-+ + + + + + + + + +-+ + +-+ +-+-+
|     |   |     |     | |   | | |       |
+ +-+ +-+-+-+ +-+ + + +-+-+ + +-+-+-+-+ +
| |   |   | | | | | |     | | |   |   | |
+-+-+ + + + + + + +-+-+ +-+ +-+-+ + +-+ +
|       | | | | |     |   | |           |
+-+ +-+-+ + +-+ +-+ +-+-+-+ +-+ + + +-+-+
| |   | | | | | |   | |   |     | |     |
+ + + + + + + + +-+ + + +-+ +-+-+-+ + + +
|   |   |     |       |     |   | | | | |
+ +-+-+-+ + +-+ +-+ + +-+ +-+ + + + +-+-+
|   |   | |   |   | | |     | | |       |
+ +-+-+ +-+-+-+-+-+ +-+ +-+ + +-+ +-+-+-+
|   |   |   |   |       | | |       | | |
+ +-+-+ +-+ + +-+ +-+-+ + +-+-+ +-+-+ + +
|     |       | | |       | |   |   | | |
+-+-+ + +-+-+ + +-+-+-+ +-+ +-+ + +-+ + +
|     |   |       |       | | | |     | |
+-+ + + +-+ +-+-+-+ + +-+-+ + +-+ +-+ + +
| | |   |   |     | |   |         | |   |
+ +-+ +-+-+ +-+ +-+-+ + + +-+-+-+ + + +-+
|   | |       |       |     |     | | | |
+ + +-+ +-+-+-+-+-+-+ +-+ +-+ +-+ + + + +
| | |     |       | | |   |     | |     |
+-+ + +-+ + + +-+-+ + + +-+-+-+ +-+ + +-+
| |   |     | |       |   | |     | |   |
+ + +-+ +-+-+-+ + +-+-+ +-+ +-+ +-+ +-+-+
| | |   |   | | |     | |         |     |
+ + +-+ + + + +-+ +-+-+ +-+ +-+-+-+ +-+ +
|   |     | |       |   |         |   | |
+-+-+ +-+-+-+-+ + + +-+-+ + +-+-+ + +-+ +
|         |     | |   |   |     | |   | |
+-+-+-+-+-+-+-+-+-+-+-+-+-+-+-+-+-+-+-+-+
