50
50
+-+-+-+-+-+-+-+-+-+-+-+-+-+-+-+-+-+-+-+-+-+-+-+-+-+-+-+-+-+-+-+-+-+-+-+-+-+-+-+-+-+-+-+-+-+-+-+-+-+-+
|     | | |   |     |         | | |       | |   |   |   | | | |   |     | |     |   | |             |
+ +-+-+ + + +-+ +-+-+ + +-+-+-+ + +-+ +-+-+ + +-+-+ + +-+ + + + +-+ +-+ + +-+-+ +-+ + + +-+ +-+-+-+ +
|     |               |     |   | |             |   |   |         | |     | |   |       |     |     |
+-+-+ + +-+-+ + +-+-+-+ +-+ + +-+ +-+-+ +-+-+-+ + + + +-+-+-+ +-+-+ + +-+-+ + + +-+-+-+-+-+ + +-+-+ +
|   |   |   | |     | | |   |         |     |     | |   |   |       | | | |   |       | |   |   | | |
+ +-+-+ +-+ +-+-+-+ + +-+ +-+ + +-+ +-+ +-+-+-+-+-+ +-+ +-+ + + + +-+-+ + +-+-+ +-+ + + + + +-+-+ + +
|     |         |   |   | | | | |     |         |           | | |   |     |     |   | | | |     | | |
+ + +-+ + +-+ + +-+ + +-+ + +-+ + + +-+ + +-+ +-+-+ + + +-+-+-+-+ +-+-+ +-+ + +-+ +-+-+ + +-+ + + + +
| | |   |   | | |     |   |     | |     | | | |   | | |   |             |   |   | |     |   | | | | |
+ +-+-+ +-+-+-+-+ +-+-+ +-+-+ +-+-+ +-+ + + + +-+ + + +-+ + +-+-+ +-+-+ +-+ +-+-+-+-+-+ + +-+-+-+ +-+
| |   |   |     |   |   |     |     | | |   |   | | | |   | |       |     |   |   |     | | |   | | |
+ + + +-+ +-+ +-+-+-+ +-+ +-+ +-+-+-+ + +-+-+-+ + +-+-+ +-+ +-+-+-+ +-+ +-+ + +-+ + +-+ + + + +-+ + +
|   |       | |     |     |   |   |   |       | |       |     | |     |     |   | | | |   |   | | | |
+ + +-+ +-+-+ +-+ +-+-+-+-+-+-+-+ + + +-+ + +-+-+ + +-+ +-+ +-+ +-+-+ + + +-+ + + +-+ +-+ + + + + + +
| | |     |           | |       | | |     |   | | |   |     | |   |   | | |   |   | | | |   |   |   |
+-+-+-+ +-+ +-+-+ +-+ + + + +-+-+ + + +-+-+-+-+ + +-+-+ + + + + + + +-+ +-+-+ +-+ + + + +-+-+ +-+ + +
|   |     | |   |   |   | |       | |     | |     | |   | |     | | |     |   | |             |   | |
+ + + +-+ + + +-+-+ + + + + + + +-+ +-+ +-+ +-+-+-+ +-+ + + +-+-+-+-+ + +-+ +-+ +-+ +-+-+ +-+-+ +-+-+
| |     | |   |   | | |   | | |   | |             |   | | |       | | |   | |     |     |       | | |
+ + +-+-+-+ +-+ +-+-+-+ +-+-+ + +-+-+ +-+-+-+ + +-+ +-+-+ +-+ + +-+ +-+-+-+ +-+-+ +-+-+ +-+-+-+-+ + +
| | | |         |     |   | | |   | |   |     |   |     | |   | |   |           |   |       |     | |
+ +-+ +-+ +-+-+-+ +-+ + +-+ + +-+ + +-+-+ +-+ + +-+ + + + + +-+-+-+ +-+-+ +-+ +-+ + +-+ +-+-+-+ + + +
|     |     | |     | | | |   | |   | | | |   |     | | | |     |   |     |       |   | |   |   |   |
+-+-+-+-+-+-+ +-+ +-+-+ + + + + +-+-+ + + + + +-+-+ +-+-+ + +-+ +-+ +-+ + +-+-+ + +-+-+ +-+ + +-+-+-+
|       |           | | | | |       |     | | |   |   | | | |     | | | |     | |     | | |   |     |
+-+ + +-+ +-+-+-+-+ + + + + +-+-+ +-+-+-+-+ +-+-+ +-+-+ +-+-+ +-+ + + + + +-+-+-+ +-+ + + + +-+-+ + +
|   |   | | | | | |     |   | | |     |       |   |     | | |   | | |   |   |     |   |       |   | |
+ +-+-+-+-+ + + + +-+-+-+-+-+ + + +-+-+-+ + +-+-+ + + +-+ + +-+-+-+ + + +-+-+-+-+ +-+ +-+ + + + +-+-+
|         |   |   |     | |       |   | | |       | | |     |   | |   | |     | | | | | | | | |   | |
+ + +-+-+ + +-+ + + +-+-+ +-+ +-+-+ +-+ + +-+-+ + +-+ +-+ +-+-+ + +-+ +-+ + + + +-+ +-+ + +-+-+ +-+ +
| | |   | | |   | | |   |         | |   |     | | |       | | | | | | | | | | |   | | |           | |
+ + +-+ +-+ + +-+-+ +-+ +-+-+ +-+ + + +-+ +-+-+-+-+-+-+ + + + + + + + + + + +-+ + + + +-+ +-+-+ +-+ +
| |     |     |     |   | |   | |   |   | |     |     | |   |   |   |     | |   |     | | |       | |
+-+ +-+-+-+ +-+ +-+ +-+ + + + + + +-+ + +-+-+-+ + + +-+ +-+ + +-+ +-+-+ +-+-+-+-+-+-+ + +-+ +-+-+-+ +
|       | |     | |       | | | | | | | |   |   | |       |   |         |     |         |           |
+ +-+ + + + + + + +-+-+-+-+-+ + +-+ +-+ +-+ + +-+-+ +-+ +-+-+ + + + +-+-+ +-+-+-+ +-+-+-+-+-+-+ +-+ +
| |   |     | |   | | |   |       | | | |       |   |     | |   | | |   | |     | |     |     | | | |
+-+ +-+ + +-+-+ + + + + +-+-+-+-+ + + + +-+ +-+-+ + +-+-+-+ + +-+-+ + +-+ + +-+-+ + +-+-+-+-+ + + +-+
|   |   |   |   |         | |     | |       |     | |     |   |   |       |       |     | |     |   |
+-+ +-+-+-+-+ +-+-+ +-+-+-+ + + + + + + +-+ + +-+-+ + +-+-+-+ + +-+-+-+ +-+ +-+ +-+-+ + + + + +-+ +-+
|     |     |   | |   | | |   | | |   | |         |   |         |     |     |     | | |   | |   | | |
+-+-+ +-+ +-+-+-+ + + + + +-+-+ +-+ + +-+-+ + +-+ + +-+-+-+-+ + + +-+ +-+-+ + +-+ + + + + + +-+ + + +
|           | |     | | |         | |   |   |   | | | |     | | | | | | | | |   |     | | | |     | |
+-+ +-+-+-+ + + + +-+-+ + +-+-+ +-+-+ +-+-+-+-+-+-+ + + + +-+-+-+ + + + + +-+-+ +-+ + + + +-+-+ +-+ +
|   |   |     | |   | |     |     | |   |   | |   |   | | | | | | | |     | |   |   | | |   | | |   |
+-+ + +-+ +-+-+-+-+ + + +-+-+ +-+ + + +-+ +-+ +-+ + +-+-+ + + + +-+ + +-+ + +-+ +-+ +-+-+-+-+ +-+ +-+
|     | |       |     | |   | |     |   |   |     | | |     | | |       |   |   |       | |   |     |
+ + + + + + +-+-+ +-+ +-+ + +-+-+ + +-+ +-+ + +-+ +-+ +-+ +-+ + + +-+-+-+-+-+-+-+ +-+-+-+ + +-+-+ +-+
| | |   | |   | | |       | |     | |     | |   |   |     |   | |       |             |       |     |
+ + +-+-+-+-+-+ +-+-+-+-+-+ + + +-+ +-+-+ + + +-+ +-+ +-+ + + + +-+ + +-+-+ + + + +-+ +-+ +-+ + +-+ +
| |     |     |     | | |   | |   |           | | |   |     | |     |       | | |   | |     |   |   |
+ +-+ +-+ +-+ +-+-+ + + +-+ +-+-+-+ + +-+-+-+-+ +-+ +-+-+ +-+-+ + +-+-+-+-+-+ +-+ + +-+-+-+-+-+ +-+ +
|   | | |   | |       |     |   | | | |     |   |   |   | |     |         |   |   | |     |       | |
+-+ + + +-+ + +-+ +-+ + +-+ +-+ + + +-+ +-+-+ +-+ + + +-+ + +-+-+-+-+-+-+-+-+-+-+ +-+ +-+ +-+-+ + +-+
| | | |     | | | |   | |     |   | |           | | |     | |       |         |   |     | | | | |   |
+ +-+ +-+ + + + + +-+-+ + + +-+ +-+ +-+-+ +-+-+ +-+-+ +-+-+ +-+ + +-+ +-+ + +-+-+ +-+ +-+-+ + +-+ +-+
|     | | | | |         | |   |         | | |   | | |   |       | | | |   |         |     |     | | |
+-+ + + + +-+ +-+-+ + +-+-+ +-+-+ +-+-+ + + + + + + +-+ +-+ +-+ +-+ + + + + + +-+ +-+-+-+ +-+ + + + +
|   | |     |   | | | |   | |       | |     | |   |     |   | | |   | | | | | |     | | |   | | | | |
+ + +-+-+-+ +-+ + + +-+-+ +-+-+-+-+-+ + + +-+-+-+-+-+-+ +-+-+ +-+ +-+ + +-+ +-+-+ +-+ + + + + + + + +
| | | |   | | |         |     |   |     |         |   |     | |       | | | | | |   | |   |   |   | |
+ +-+ + + + + +-+-+ +-+ + +-+-+ + +-+-+ +-+ +-+ +-+-+ +-+-+ + +-+-+-+ +-+ + + + +-+ + +-+-+-+ +-+ + +
| |     | | |     | |         | |       |     | | |     |           | |         |     | |   |   | | |
+ + +-+-+ + + + + + +-+-+-+-+ + +-+ + +-+ +-+-+-+ +-+ +-+ +-+ +-+ + + +-+ +-+-+ +-+-+-+ +-+ + + +-+ +
| | |   |   | | |   |   |         | | |   | |       | |   |     | |   |     |     |     |     |   | |
+ +-+ +-+-+-+ +-+-+-+-+ +-+ +-+-+-+-+ + +-+ + + +-+-+ + + +-+ + +-+ +-+ +-+-+-+ + +-+-+ +-+ +-+-+ + +
| | |   |   |     | | |   | |       | | |     |         | | | | | |   | | |   | | |             |   |
+ + + + +-+ +-+-+ + + +-+ +-+-+ + + + + + +-+-+-+ + +-+-+ + +-+ + +-+-+ + +-+ +-+ +-+ +-+-+-+-+ +-+ +
|   | |     |   |   | | |     | | | | | | |     | | | |   |       |   | | |       | | |         | | |
+-+ + + +-+-+ +-+-+-+ + + +-+ + + +-+-+-+-+-+ +-+-+-+ + +-+-+-+-+ +-+ + + +-+-+ +-+ + +-+-+-+-+-+ + +
|     |   |     | |     | |   | | |           | | |     | | | |   |   |   |   |           |         |
+ +-+-+-+-+-+ +-+ +-+-+ + +-+-+-+ +-+-+-+ + + + + +-+ +-+ + + + + + + +-+-+-+ + + +-+-+-+ +-+ + +-+ +
| | | | | |     | | |         |   | |     | |       | |     |   |   | | |   |   |     |   |   | | | |
+-+ + + + +-+-+ + + + + + +-+-+-+ + + +-+ + + + + +-+ +-+ + +-+-+-+-+ + + +-+-+-+ + + +-+-+ + +-+ +-+
| |   |     |   |   | | |     | |     |   | | | | | | |   |     | | | |   | |   | | |   |   |     | |
+ + + +-+ +-+ + + +-+-+-+-+ +-+ + +-+ + +-+-+ +-+ + +-+ +-+-+ +-+ + +-+-+ + +-+ + +-+-+ +-+ +-+ + + +
| | |   |     | |   |         | |   | |     | |   |     | |         |       |     |     | | | | |   |
+ +-+ +-+ + +-+-+ +-+-+ + +-+ + +-+-+ +-+-+-+ +-+ + +-+ + +-+ + +-+ +-+-+ + +-+-+ +-+-+-+ +-+ + +-+-+
|         |   | |     | |   | | |       |   | |   | |   | |   |   |       | |     | |         |     |
+ +-+-+ +-+ +-+ +-+-+ + + +-+ + + +-+ + +-+ +-+-+ + + + + +-+ + + +-+-+-+-+-+ + +-+ +-+-+-+ + +-+-+-+
|   |   |   | |       | | | |   | | | |       |   | | | |   | | |         | | |       |     |   | | |
+-+-+-+-+ +-+ + +-+ + +-+-+ +-+ + + + +-+-+ + +-+ +-+-+-+ + +-+-+ + +-+ + + +-+-+ +-+ +-+ + +-+ + + +
| |         |   |   |   |   |   |   | |     | | | |     | | |     | |   |   |     | | |   | |       |
+ +-+-+-+-+ +-+-+ + +-+-+-+ + +-+ +-+-+-+-+ +-+ + + +-+ + +-+ + +-+-+-+-+-+ + + +-+ +-+-+ +-+-+ +-+ +
| | |     |       | | |       |       | | |   | |   |       | |     |         | |   | |     |     | |
+ + +-+ + + +-+ + + + +-+ + +-+ + +-+-+ + + +-+ +-+-+-+ + +-+-+ +-+-+-+ +-+ +-+-+ +-+ +-+-+-+-+ +-+ +
|     | | |   | | |       |     |   | |       |       | | |   | | |   | |   |     |       |       | |
+-+ +-+-+ +-+ +-+-+ +-+-+-+ +-+-+-+ + + +-+ + +-+ +-+-+ + +-+ + + + +-+-+-+ + +-+-+ + +-+-+-+-+ +-+ +
|         | |     | |     | | |   | |   | | |   |       |       |       |   |   |   |     | | |   | |
+ +-+ + +-+ +-+ +-+-+-+-+ +-+ +-+ +-+ +-+ + + +-+ +-+ +-+-+ + +-+-+ +-+-+ + + +-+ +-+-+ +-+ + + +-+-+
| |   |     |     |   | |   | |     |   | | | |   |   |   | |   |   | | | |     |   |       |     | |
+-+ +-+ +-+ +-+-+ + +-+ + +-+ +-+ +-+-+-+ + + + +-+-+-+ +-+ +-+-+ +-+ + +-+ + + +-+ +-+-+-+ +-+-+ + +
|     | |   |         | |         | | |   | | |     |           |       |   | |   |     | | |   | | |
+ + +-+-+-+ +-+-+-+-+ + +-+ +-+ +-+ + +-+ + +-+-+ +-+-+-+-+-+-+-+-+-+ +-+ +-+-+ + +-+-+-+ + + + + + +
| | |       |                 | |           | |   |     | |       |           | | |     |     | |   |
+-+ +-+-+-+ + +-+-+-+ +-+-+-+ +-+-+-+-+-+ + + +-+ +-+ + + + + +-+ +-+-+-+-+ +-+-+-+-+ + + +-+ +-+ + +
|   |     | |   | | |   |   |   |   |     |   |   |   | |   | |   | |     |           | |   |     | |
+ + + +-+-+ + +-+ + + +-+-+ +-+ + +-+ + +-+-+ + +-+ +-+ +-+ +-+-+-+ + +-+ + + +-+ +-+-+ + + + +-+-+ +
| |   |         |       |           | | |     |       | |               |   |   |   |     | | |     |
+-+-+-+-+-+-+-+-+-+-+-+-+-+-+-+-+-+-+-+-+-+-+-+-+-+-+-+-+-+-+-+-+-+-+-+-+-+-+-+-+-+-+-+-+-+-+-+-+-+-+
