5
5
+-+-+-+-+-+
|       | |
+ + +-+-+ +
| |   |   |
+ +-+ + +-+
|   | |   |
+-+ +-+ +-+
|     | | |
+-+ + + + +
|   |     |
+-+-+-+-+-+
