10
6
+-+-+-+-+-+-+-+-+-+-+
|   |   |       | | |
+-+ +-+ + +-+-+-+ + +
|   |           | | |
+-+ + +-+ + +-+-+ + +
|     |   |     |   |
+-+-+ +-+-+ +-+ + + +
|     |       | | | |
+ +-+ + +-+ +-+ + +-+
|   | | | |   | |   |
+ +-+-+ + +-+ +-+ +-+
|     |     |       |
+-+-+-+-+-+-+-+-+-+-+
