30
30
+-+-+-+-+-+-+-+-+-+-+-+-+-+-+-+-+-+-+-+-+-+-+-+-+-+-+-+-+-+-+
|   |   |     |     |     |     | |         |       | | |   |
+ +-+ + +-+ + + +-+ + +-+-+ + +-+ + + + +-+ +-+ + +-+ + + +-+
| |   |     | | |   | |   | | | |   | | | |   | | |   |     |
+ +-+-+ +-+ +-+ +-+-+ + + + + + + +-+-+ + + +-+ +-+ + +-+ +-+
|   | | |   | |     | | | | | | |   |     |   |   | |   |   |
+-+ + +-+ + + +-+ +-+ +-+ + +-+ +-+ + + +-+ +-+-+ + +-+ + +-+
|     |   | |     |   |   |   |     | | |           |       |
+-+-+ +-+-+ +-+-+ + +-+ +-+-+ + +-+-+-+-+-+ +-+ + + +-+ +-+-+
|       |             |       | |       |   |   | |   | | | |
+ +-+-+ +-+-+ + +-+-+-+ +-+ +-+ +-+ +-+-+-+-+-+ + + +-+-+ + +
| |     |     | | | | | | |   |       | |     | | |         |
+-+ +-+ +-+-+ +-+ + + + + + +-+ + +-+-+ + + + +-+ +-+ + +-+-+
|   |             |   |   |   | | |   |   | |   | |   |     |
+-+-+-+ +-+-+ +-+ + +-+ +-+ +-+ +-+ +-+ +-+-+ +-+ + +-+-+ +-+
| |       |   |   |   | |         |   |   |       |     |   |
+ +-+ +-+-+-+ +-+ +-+ +-+-+-+-+-+ +-+ +-+ +-+-+-+-+ +-+-+ +-+
|     |     |   |   |       |     |   |   | | |         |   |
+ +-+-+-+ +-+-+-+-+-+-+-+-+ +-+-+ + +-+ +-+ + +-+-+ + +-+ +-+
|       | |     |   |     | |     | |   |       |   | |   | |
+ +-+-+ + + +-+-+ + + +-+-+ + +-+-+ + +-+-+ + +-+-+-+-+ + + +
| |             | | |     |     |     | | | |     | |   |   |
+ +-+ +-+-+ +-+ +-+ + +-+-+-+ +-+-+-+ + + + +-+ + + +-+-+ +-+
|   | | |     |             | |   | |   |   |   | |         |
+ +-+-+ +-+-+-+ +-+ + +-+-+ +-+ +-+ +-+ +-+-+ +-+-+-+ + +-+-+
|   |       |     | | |       |   |       |   |       |   | |
+-+ +-+-+-+ + +-+ +-+ + +-+-+ +-+ + +-+ +-+ + +-+-+-+-+-+-+ +
|   | |     | |   | | |   |   |     | |   | | |   | | | | | |
+ + + + +-+ + +-+ + +-+-+ +-+-+-+-+ + +-+ + + + +-+ + + + + +
| |   |   |   |     |   | | | |         | | |     | |       |
+-+ +-+-+-+-+ +-+-+-+ +-+-+ + +-+ +-+-+ +-+-+ +-+-+ + +-+-+ +
|       | |     | |       |   |     |     | |     |   | |   |
+-+ +-+-+ +-+-+ + + + +-+ + + +-+ +-+ +-+ + + + + +-+ + +-+-+
| | |     |         | |     |     |     | |   | | | |     | |
+ + + +-+ +-+ +-+-+ +-+-+ +-+ + + +-+ +-+ + +-+ +-+ +-+ +-+ +
|       |   |     | |   | |   | |   |   | |   |           | |
+ + + +-+ +-+ + +-+ + +-+ +-+ +-+-+-+ +-+-+-+ +-+ + + +-+-+ +
| | | | |   | | | | |   | |     |     |       | | | |   |   |
+ +-+ + + +-+-+-+ + +-+ +-+ + +-+ + + + + +-+-+ +-+ + +-+ + +
| |     |   | |         |   | |   | | | | |       | | |   | |
+-+-+-+-+-+ + +-+ + +-+-+ +-+-+-+ + + + +-+-+ +-+-+ + +-+ +-+
|   | |   | |     |     | | |     | | |       |   | | | |   |
+-+ + + +-+-+-+-+ + +-+ +-+ +-+-+ +-+ + +-+ + + +-+ +-+ +-+ +
|     | | |   | | | |     |       |   | | | | | | |         |
+-+-+ + + + +-+ +-+-+-+-+-+-+-+-+ +-+-+ + +-+-+ + + +-+-+-+-+
|     |     | |   |     |     |           |     |           |
+ +-+-+ +-+ + + +-+-+-+ +-+-+ +-+-+-+-+-+ + + +-+-+-+ + + + +
|     |   | |   |     | |   |       | | | | |   |   | | | | |
+ +-+-+ +-+ + + + + +-+ + +-+-+ + +-+ + +-+-+-+ +-+ +-+ + +-+
|     | |     |   |             | | |           |       | | |
+ + +-+-+-+ + + + +-+ +-+-+-+-+ +-+ + + +-+-+-+ +-+ +-+ +-+ +
| |   | |   | | |   |     | |       | | |     | | |   |     |
+ +-+-+ +-+ +-+-+-+-+ + +-+ +-+-+ +-+ +-+-+ +-+ + + + +-+-+ +
|   |   | | |   |     | |         |     | | |       | |     |
+-+ +-+ + + + +-+ + + +-+-+ +-+-+ + +-+-+ + + +-+ +-+-+-+ +-+
| |         | |   | |   |   |       | | | |     |     | |   |
+ +-+ +-+-+ + +-+-+-+-+ +-+-+ +-+-+ + + + +-+ +-+ + +-+ + +-+
|       |         | | | |   | |       |   | | | | |   |     |
+-+-+-+-+ + +-+-+ + + + + + +-+ + +-+ + + + + + +-+ +-+ +-+-+
|         | |         | | |     |   |   |   |     |   |     |
+-+-+-+-+-+-+-+-+-+-+-+-+-+-+-+-+-+-+-+-+-+-+-+-+-+-+-+-+-+-+
