20
20
+-+-+-+-+-+-+-+-+-+-+-+-+-+-+-+-+-+-+-+-+
|   |     | |     |   | |   |           |
+-+ + +-+-+ + +-+-+ +-+ +-+ + +-+ +-+-+-+
| |       |   | |     | | | |   |       |
+ + +-+-+-+ +-+ +-+ +-+ + + + +-+ +-+-+ +
|           |   |   | |       | |   |   |
+ +-+ +-+ +-+ + +-+ + +-+ +-+-+ + +-+-+ +
| |   | | | | | |       |   |       | | |
+-+-+ + + + +-+ +-+ +-+ + + +-+ + + + + +
| | | | |     | | | |     | |   | | |   |
+ + + + +-+ + + + + +-+ +-+ +-+-+-+-+ + +
|       |   | |     |   | |   | | |   | |
+ +-+ +-+-+ + +-+ +-+-+ + + +-+ + + +-+ +
|   | |   | |   |     | |     |   | | | |
+-+-+ + + +-+ +-+-+ +-+-+-+-+ +-+ +-+ +-+
|     | | | |     | |   | |   |     | | |
+ +-+ + + + + +-+-+ + + + +-+ + +-+ + + +
|   |   | |     |   | | | |   | | |     |
+ +-+-+-+-+-+ +-+ + +-+ + + +-+ + + +-+ +
| | |             |       | |     | |   |
+ + +-+ +-+ +-+-+ +-+ +-+ + + +-+-+-+-+ +
|   |   | |     |   | |   |     |       |
+-+-+ + + + + +-+-+-+-+ +-+-+-+-+-+-+ +-+
| |   |   | | |       | | |     | | |   |
+ +-+-+ +-+-+ +-+ +-+ + + +-+ + + + +-+-+
|         |   | |   | | | |   |     |   |
+-+ + + + + + + +-+ +-+ + + +-+ +-+-+ +-+
| | | | | | | | |   |   |     |     |   |
+ + +-+-+ +-+-+ + + + +-+-+ +-+ +-+ + + +
|   |   |       | | |     | |   |     | |
+-+ + +-+-+ +-+-+ +-+ + +-+-+-+ + +-+ +-+
| | | |   | |   | |   |   |   | | |     |
+ + + + +-+ + +-+ +-+-+-+ +-+ +-+-+-+ +-+
|     | | |       | | |       |         |
+-+ + + + + +-+ +-+ + +-+-+ +-+ + + + +-+
|   |     |   | |     |       | | | |   |
+ +-+ +-+ + + + + + + +-+ +-+-+ +-+-+-+-+
|   |   | | | | | | | |                 |
+-+ + +-+-+-+-+-+ +-+ +-+ + +-+-+-+-+ +-+
|   |           | |       |   |         |
+-+-+-+-+-+-+-+-+-+-+-+-+-+-+-+-+-+-+-+-+
