20
20
+-+-+-+-+-+-+-+-+-+-+-+-+-+-+-+-+-+-+-+-+
| | | |     | | | | | |   | |     |   | |
+ + + + +-+-+ + + + + +-+ + + +-+-+ +-+ +
| |   | |                 |             |
+ +-+ + +-+-+-+-+ +-+-+ +-+-+ +-+-+ + + +
|   | |   | | |   | | |       |   | | | |
+ + + + +-+ + + +-+ + + +-+-+ + +-+-+-+ +
| | |     | | |       | |   |         | |
+ + +-+-+ + + + + + +-+ + +-+-+-+ + + +-+
| |           | | |   | | |       | |   |
+ +-+-+-+ +-+-+-+ + + + + +-+ +-+-+-+-+-+
| | |           | | | |   |             |
+ + + +-+ +-+ +-+-+-+-+-+ +-+-+-+-+ + +-+
|   | |   | |   | |   |   |   | | | | | |
+ +-+-+ +-+ +-+-+ + + + +-+ +-+ + +-+ + +
|   | | |     | |   |   |               |
+ +-+ + + +-+ + + +-+-+ +-+-+-+-+-+ + +-+
|   |     |           |       |     |   |
+ + +-+ +-+ +-+-+-+ + +-+ +-+-+ +-+ +-+ +
| | |     | | |   | |   |     |   | |   |
+ +-+-+ + +-+ +-+ +-+ +-+-+-+-+-+-+ +-+-+
| | | | |     | | | |     |   | | |     |
+ + + +-+ + + + + + +-+-+-+-+ + + +-+ + +
|   |   | | | |     | |         |     | |
+-+ + +-+ +-+ +-+ + + + +-+-+-+-+ +-+ +-+
| |     | |   | | |     |   |   | |   | |
+ + +-+ +-+-+-+ +-+ + +-+ +-+ +-+-+ +-+ +
|   |   |   |     | |     |   | |     | |
+-+ + + + + +-+-+ + +-+-+-+ + + +-+-+-+ +
|   | | | |               | | | |       |
+-+-+ + +-+ +-+-+-+-+ + + +-+ + + +-+-+ +
| |   |         |     | |     |       | |
+ + +-+-+ +-+ +-+-+-+ + +-+ + + +-+ +-+-+
|       | |       | | | |   |     | |   |
+ + +-+ +-+-+ +-+-+ + +-+-+-+-+ +-+-+ +-+
| |   | |   | | |     |   |             |
+ +-+-+ +-+ +-+ +-+ +-+ +-+ + +-+-+-+ + +
|   |   |       |   |       | | |     | |
+ +-+ +-+ +-+ + + +-+-+-+ + +-+ +-+ + + +
|   |   |   | |   |       |     |   | | |
+-+-+-+-+-+-+-+-+-+-+-+-+-+-+-+-+-+-+-+-+
