30
30
+-+-+-+-+-+-+-+-+-+-+-+-+-+-+-+-+-+-+-+-+-+-+-+-+-+-+-+-+-+-+
| |     |   |     | |     | |   | | |     |           | |   |
+ +-+-+ +-+ +-+-+ + + + + + +-+ + + + + + +-+ +-+-+ + + +-+ +
|   | |       | |     | | |         | | | | |   | | |       |
+-+ + + +-+ +-+ + +-+ +-+-+-+ +-+-+-+-+ +-+ + +-+ +-+-+ + +-+
| | |     |   |   |   | |       |     |             | | |   |
+ + +-+ +-+ +-+ +-+-+-+ +-+-+ + + +-+-+ +-+-+-+-+ +-+ +-+-+ +
|   |     | | |     |   |     | | | | | | | |     |     |   |
+ +-+ +-+-+ + + + +-+ +-+ +-+-+ + + + +-+ + + + +-+ +-+ +-+-+
| |   |   |     | | | |   |   | |   |       | |   | |   |   |
+ + + +-+ +-+ + +-+ + +-+ + +-+-+-+ +-+-+ +-+ +-+-+-+ +-+ + +
|   |   | | | | |   |         |     |   |   |       | | | | |
+-+ +-+ + + +-+ + + + +-+-+ +-+-+ +-+-+ + +-+ +-+ +-+ + +-+ +
|     |   |   | | |       | |   |     | |   |   |       | | |
+-+-+-+ + + +-+ +-+-+ +-+-+-+ +-+ + + + + +-+-+ + +-+-+-+ + +
|       |   |             |   |   | |     |     | |     |   |
+-+-+ +-+ +-+-+-+-+-+-+ + +-+ +-+-+-+ + + + +-+ +-+-+ +-+ +-+
| | |   |   |     | | | |     | |     | |   | | |     |     |
+ + +-+-+ +-+-+ + + + +-+-+ +-+ + +-+ +-+ +-+ +-+ + +-+ +-+ +
|     | |       | |   | |     |   |   | |   |     |   | | | |
+ + +-+ + +-+ + +-+ +-+ +-+-+ + +-+-+ + +-+ +-+ + +-+-+ + +-+
| |   |   | | |   | | | | |   | | |   | |       | |         |
+-+-+ +-+-+ + +-+-+ + + + + +-+ + + +-+ + +-+-+ + + + + +-+ +
|     |     | |     | | | |       |     | |   | | | | | | | |
+-+-+ +-+ + + + +-+ + + + + +-+-+-+ + +-+-+ + + + +-+ +-+ +-+
|       | | | | | | |     |   |     |   | | | | |           |
+ +-+ +-+ +-+ +-+ + + + + +-+-+ + +-+-+ + + +-+-+ + + +-+-+ +
| | |     |     |   | | |   |   | |   | |       | | |   |   |
+-+ + +-+-+ +-+-+ +-+-+ +-+-+ + + +-+ + + +-+-+ +-+-+-+ + + +
|       |   |       |         | | |   | |   |   |       | | |
+-+ +-+-+-+-+-+ + +-+ +-+ + +-+-+-+-+ +-+-+-+ +-+-+-+ +-+-+-+
|   |     |     |   |   | |       |     |           |       |
+ +-+ +-+ + +-+ + + + +-+-+ + +-+-+-+ +-+ + + +-+-+-+-+ + + +
|       |     | | |   | |   |   |   |   | | |           | | |
+ + +-+ +-+ +-+-+ + +-+ +-+-+-+-+ + +-+ +-+ +-+-+ +-+ +-+ + +
| |   | |     |   | | |     | |   |           | | | | | | | |
+-+-+ +-+-+ +-+-+ +-+ +-+ + + +-+-+-+-+-+-+ + + + + + + +-+-+
|     |   | | |   |     | |           | | | |   |   |     | |
+ +-+-+ +-+-+ +-+-+-+ + + +-+ +-+ +-+-+ + +-+-+ +-+ + + +-+ +
|     | |       |     | | |     |   | |     |   |   | |     |
+-+ +-+ + +-+-+ +-+-+-+ +-+-+-+ +-+ + + +-+-+-+ +-+-+ +-+-+ +
|   |     |     |       |   | | | |   |     |       |   | | |
+-+-+-+ + +-+ + + + + + +-+ + + + + +-+ + +-+-+ +-+-+ +-+ +-+
|   |   | |   |   | | | |     | |   |   |   | |     |   |   |
+-+ + +-+-+-+-+ + + +-+-+ +-+-+ +-+ + +-+-+ + + +-+-+-+-+ +-+
| |         | | | | |   |   |   | | | | | |           | | | |
+ +-+ +-+-+ + +-+ + + +-+ + +-+ + + +-+ + +-+-+-+-+ +-+ + + +
| |   |       | | |   |   |     |         | |   |           |
+ +-+-+ +-+ +-+ +-+-+-+ +-+ +-+ +-+ + +-+-+ + +-+-+ + +-+-+-+
|       |   | | | |   | | |   | |   |         |     |   | | |
+-+-+ +-+ + + + + + + +-+ + +-+-+-+-+ + + + +-+ +-+ + +-+ + +
|     | | |   |     | |   |   |     | | | |     |   |   | | |
+-+ + + + +-+ +-+ +-+ + +-+-+-+-+ +-+-+-+ + +-+-+ +-+ +-+ + +
| | | |   |   |     |           |   |     | | | | | | | |   |
+ + + +-+-+-+ +-+-+-+-+-+ +-+ +-+ + + +-+-+-+ + + + + + + +-+
|   |     |   | | | |       |   | | | |       |     | |   | |
+ +-+-+-+-+ + + + + +-+ +-+-+-+ + +-+-+ +-+ +-+-+ + + + + + +
|     |   | |                 |         |   |     | |   |   |
+ + + + +-+ +-+ + +-+-+-+ +-+ +-+ +-+-+-+ + + + +-+ +-+-+ +-+
| | |     |   | |     |   |   |       |   |   | |       |   |
+-+-+-+-+-+-+-+-+-+-+-+-+-+-+-+-+-+-+-+-+-+-+-+-+-+-+-+-+-+-+
