30
30
+-+-+-+-+-+-+-+-+-+-+-+-+-+-+-+-+-+-+-+-+-+-+-+-+-+-+-+-+-+-+
|   | | | | |     | |   |   |   |       |   |   |           |
+-+ + + + + +-+ + + + +-+-+ +-+ + +-+-+ + + +-+ + + + +-+ + +
|   | |       | |     |     |         | | | |   | | |   | | |
+ + + +-+-+ +-+-+ + + +-+ +-+ +-+ +-+-+ + +-+-+ + +-+-+-+ +-+
| |           |   | |   |   | | | |   | |       | |   | |   |
+ + +-+ +-+ +-+ +-+-+ +-+-+ +-+ +-+ +-+ + + +-+-+-+-+ + + +-+
| |   |   |         | |   |       |       |     | |     | | |
+-+-+-+-+ +-+ +-+-+-+-+-+ +-+ +-+ +-+-+-+ +-+ +-+ + +-+ + + +
| | | |     | |       | | |   |   |       | |         | | | |
+ + + + +-+ +-+ +-+ + + + + +-+ + + + + + + +-+ +-+-+-+-+ + +
|         | | | |   |     | |   | | | | |     | |     |     |
+-+-+-+-+ +-+ +-+-+-+ +-+ +-+ +-+-+ +-+-+-+ +-+-+-+-+ +-+ +-+
| |     |       |       | | |   |   |   |   |   |   |     | |
+ +-+-+ + +-+-+-+ +-+-+ + + + + + +-+ + + + + +-+ + + + + + +
|       | | |   | |   | |     |     | |   | |   | |   | |   |
+-+ +-+ + + +-+ +-+-+ +-+-+-+ + +-+-+ +-+-+ + +-+ + +-+ +-+ +
|     |     |             | | |   |   |   | |     |   | |   |
+ + +-+-+ + +-+-+-+-+ +-+-+ + +-+-+ +-+-+ + + + +-+-+-+-+-+ +
| |     | |   | |       |     |           |   |   | |   | | |
+ +-+ + + +-+-+ + +-+-+ + +-+ +-+ +-+ +-+ + +-+ +-+ + +-+ +-+
|   | | | | |     |     | | | | |   | |   | | | |     |     |
+ +-+-+-+ + + + + +-+-+-+ + +-+ + + + +-+ +-+ +-+ + + +-+ +-+
|   |   |     | |     |   | | |   | | | |     | | | | |     |
+-+ + +-+-+ +-+ + +-+-+ + + + + + +-+ + + +-+ + +-+ + + +-+ +
| |     |   |   |       | |     | | |   |   | | |   |     | |
+ + +-+-+ +-+ +-+ +-+-+ +-+-+-+ +-+ + +-+-+ + + + +-+-+ + +-+
| |     | |   |     | |   |       |     |   |   |   | | |   |
+ +-+-+ +-+-+ +-+-+ + +-+ +-+ + +-+-+-+-+-+ +-+ +-+-+ + +-+-+
|   |     |   |   |   | | | | |       | | |   |   |   |   | |
+ + + +-+-+-+-+-+ +-+ + + + +-+-+ + +-+ + +-+-+-+ + +-+-+ + +
| | | |     |       | | | |       | |         |             |
+ + + +-+ +-+-+-+-+ +-+ + +-+-+-+-+ +-+-+ + + +-+ +-+-+-+-+-+
| |   |   | |         |       |   | |   | | | |     |       |
+ +-+-+ + + +-+-+-+ + +-+-+-+ + +-+-+ + + +-+ +-+ +-+-+-+-+ +
| |   | |     |     | | | |   |     | |   | |         | |   |
+-+-+ +-+-+ +-+-+-+ +-+ + + + +-+ +-+-+ + + + +-+-+-+ + + + +
|   | |           |   | |   |     |   | | | |   |   |     | |
+-+ + +-+-+ +-+-+-+ + + +-+-+-+ +-+-+ +-+ + +-+-+ + + +-+ + +
|               |   |   |       | | |   | |     | | | | | | |
+-+-+ +-+ +-+-+ +-+ +-+-+-+ + +-+ + + + + +-+ +-+ + + + + + +
|     |     | |             | |     | |   |     | |     | | |
+-+-+-+-+ +-+ +-+ +-+-+-+ + +-+ + +-+-+-+-+-+-+ + + +-+ +-+-+
|     |   | |   |   | |   |   | |   | | | | |   | | |   |   |
+-+ +-+-+ + + +-+ +-+ + +-+-+-+-+ +-+ + + + + +-+-+-+-+ + + +
|   |       | |       |     |     | |   | |         |     | |
+ +-+ + + + + + +-+-+ + +-+-+-+-+ + +-+ + + +-+-+-+ + +-+ + +
|   | | | |   |     | |         | | |   | |   | |   | |   | |
+-+ +-+-+-+-+-+-+-+-+ + + + + +-+ + + + + +-+ + + + + + +-+ +
|           |         | | | | |       |   |     | |   |   | |
+-+-+ + + + +-+ +-+-+-+-+-+ + +-+-+-+ + +-+ +-+-+-+-+-+ +-+-+
| |   | | | |   |   |   | | | | |     |   | |   |     | | | |
+ +-+ +-+-+ + + +-+ +-+ + + +-+ + +-+ + +-+ + +-+-+ + +-+ + +
| |   |   |   |         | |   | |   | |   |       | | |   | |
+ + + +-+ +-+-+-+-+ +-+-+ +-+ + +-+-+-+ +-+ +-+-+-+ +-+ +-+ +
|   |     |     |           | | |   |   | | |   |     |     |
+ +-+-+ +-+ +-+-+ +-+-+ +-+ +-+ +-+ + +-+ + + +-+-+-+ + +-+ +
|     |   |           |   | |       |           |         | |
+-+ +-+-+-+-+-+ +-+ +-+-+ + +-+ +-+-+-+-+-+-+ + + + +-+-+-+-+
|     |         |       | |             |     |   |         |
+-+-+-+-+-+-+-+-+-+-+-+-+-+-+-+-+-+-+-+-+-+-+-+-+-+-+-+-+-+-+
