50
50
+-+-+-+-+-+-+-+-+-+-+-+-+-+-+-+-+-+-+-+-+-+-+-+-+-+-+-+-+-+-+-+-+-+-+-+-+-+-+-+-+-+-+-+-+-+-+-+-+-+-+
|       |       | |     |   | |       |       |   |   | | | |     |   |     |   |       |   |     | |
+-+ +-+-+-+-+ + + + + + +-+ + +-+-+-+ + +-+ +-+ + +-+ + + + + + + + + + + +-+ + + +-+-+-+ + +-+ +-+ +
|         |   | |   | | | |   |           |     | |           | | | | | | |   |     |     | | |     |
+-+ +-+ +-+ +-+-+-+-+ +-+ + +-+ +-+-+ +-+ +-+ +-+-+ +-+ +-+-+-+ + + +-+ + +-+ + +-+ + +-+ + + +-+-+ +
| | | |   | | | |     |   | | | | | | | | |     |     |   |   | | |   | |   | |   |   |   | | |     |
+ + + + +-+ + + + + + + + + + +-+ + + + +-+-+-+-+-+-+-+-+-+-+ + +-+-+ + +-+-+ + + +-+-+-+-+ + +-+-+ +
|   | | | |       | | | |   |       | | |   |   |   |   | |                 | | |   |   |   |       |
+ +-+ + + +-+-+ +-+ +-+ +-+-+-+ + +-+ + +-+ +-+ + +-+ + + +-+-+ + +-+-+-+ + + +-+ + +-+ + + +-+-+ +-+
| | |   |     | | | | |     |   |   |   |   | |       | |     | |     | | | | |   | | |   | |   |   |
+-+ +-+ + + + +-+ + + +-+ +-+-+-+ +-+ +-+ +-+ + +-+-+-+ + +-+ +-+-+ +-+ + +-+ +-+ +-+ + +-+ +-+ +-+ +
|         | |     | | |   |   |             |   |     |   | | | |   |   | |   |     | | |   |       |
+ +-+-+ +-+-+-+-+-+ + + + + +-+-+-+ + +-+-+-+-+ + +-+-+ +-+ +-+ +-+-+ +-+ +-+ +-+-+-+ +-+-+-+ +-+ +-+
| |   |   | |     |   | |       |   |   |             |   |     |     | | |   |   |   |   |   | |   |
+-+ + + +-+ +-+ + + +-+-+-+ +-+ +-+-+ + +-+-+ + + + +-+-+-+ +-+ + + +-+ + + +-+ +-+-+ +-+ + +-+ + + +
|   |     |     | |         | | | |   | | | | | | |   |       |   |               |       |     | | |
+-+ +-+ +-+ + +-+ + +-+-+ + + +-+ +-+ + + + +-+ +-+ +-+ +-+-+-+ + +-+ +-+-+-+-+-+-+-+ +-+ + + +-+ + +
|     | |   |   | |     | |   |   | | |     | |   |       |   | |   | | |   |       |   |   |   | | |
+ +-+-+ +-+ +-+-+-+ +-+-+ + +-+-+ + +-+ + +-+ +-+ + +-+ +-+ + +-+-+ +-+ + + + +-+ + + +-+ +-+-+ +-+-+
| |       | | |     |   | |       | |   | | |   | | | |   | |   | | |     | |   | | | | | | |       |
+-+-+ + +-+ + + + +-+-+ +-+-+-+ +-+ + +-+ + +-+ +-+ + +-+-+-+-+ + +-+-+-+ +-+ +-+ + + + + + + +-+-+ +
|     |     |   |             | |       |             | |         |         | | | |     |   |   |   |
+ + +-+-+ +-+ +-+ +-+-+ +-+ +-+ + +-+-+-+ +-+-+ +-+-+-+ +-+ +-+ +-+-+ + +-+-+-+ +-+-+ + +-+-+ + +-+ +
| | |   | | | |   |     |   |       |         |   |   |     |     |   |       |       |   |   | |   |
+-+ + +-+-+ +-+ +-+ +-+ + + +-+-+-+ +-+ +-+ + +-+-+ +-+-+-+ +-+-+-+ + +-+ +-+-+-+-+-+ +-+-+ +-+-+-+-+
|   | |       |   | |   | | |       | | |   | |       |   |   |   | | |     |       |     | |   |   |
+ +-+ + +-+ +-+ +-+ + + +-+-+-+-+ +-+ +-+-+-+-+ +-+ +-+ +-+ +-+ +-+-+-+ +-+ +-+-+ + +-+ +-+-+ + + +-+
|     | |     | | | | | | |   |   | | |   |   | |       | | |     |   | | | | |   | |   |     | |   |
+ +-+ + +-+-+-+ + +-+ + + + +-+-+-+ + + +-+-+ +-+ +-+-+-+ + + + +-+ +-+-+ + + + +-+-+ +-+-+-+ +-+ +-+
|   |     | |       | | |       |                   |   | |   | | | |   |   |     | | |             |
+-+-+ +-+-+ + +-+-+ +-+-+-+-+ +-+-+ +-+ +-+-+ + +-+-+-+ + + + + + + +-+ + + + +-+-+ + + +-+-+-+-+ +-+
| |           |       | | | |     | |     | | |     |   |   | | |         | |         |       | |   |
+ + +-+ +-+-+-+-+-+ + + + + + +-+-+ +-+ +-+ + +-+-+ +-+ +-+-+ +-+-+ +-+-+ +-+ + +-+ + + +-+-+ + + +-+
|   |             | | | |   |   | | |       |   |     |   |     | | |       | | |   |     |   |     |
+ +-+-+ + + +-+ + + +-+ +-+ + + + +-+ + +-+ +-+-+-+ + +-+ + + + + + + +-+-+ + +-+ +-+-+-+ +-+-+-+ + +
|   |   | |   | | | |   | | | |       | | | |     | | |     | | |   | |     |   |   | |     |   | | |
+-+ + + + +-+-+ + +-+-+ + + + +-+-+-+ +-+ + +-+-+ +-+-+-+-+ +-+ +-+-+ +-+-+-+-+-+-+-+ + + +-+-+ +-+ +
|   | | |   |   | | |   |     |   |   | |   |   |     | |     | |       |   |   |     | | | |     | |
+ +-+-+-+-+-+-+ +-+ +-+ +-+ + +-+ +-+-+ + +-+ +-+ +-+ + + +-+ +-+ +-+-+ +-+ +-+ + +-+ +-+ + +-+ + +-+
| |         | |       | |   |   | | |   |   |     |   |   | |     |       |   | |   | |   |     |   |
+-+-+-+-+ +-+ +-+-+-+ + +-+ + + + + + +-+ +-+-+ + +-+-+-+-+ +-+ +-+-+ +-+-+ + + + + +-+-+ +-+ +-+-+ +
|   |   |       |     |     | |   |     |   | | | |   |       | |     |   | | |   | |   |         | |
+ +-+ + +-+ +-+ +-+-+ + +-+-+-+-+ +-+ +-+-+ + + + +-+ +-+-+ +-+ + + + + +-+ +-+ + +-+-+ +-+ +-+ + +-+
|   | | | | |   |     | |         |     |       |       | |     | | |     | | | |   |         | |   |
+-+ + + + +-+-+ + + + +-+ + + +-+-+-+ +-+ +-+-+ + + +-+ + + + +-+-+-+-+ +-+ + + + +-+ + + + +-+-+ +-+
| |   |   | |     | |   | | |   |   |       |   | |   |     | |       |   |     | |   | | | | |     |
+ +-+-+ +-+ +-+ + +-+-+ + + +-+-+ + +-+-+-+ + +-+-+-+-+-+ +-+ +-+ +-+ +-+-+ +-+-+ + +-+-+-+-+ + +-+ +
|   |     |   | |   |   | | |   | |       | | | |           | |     | | | |   | |           |     | |
+ +-+ +-+ +-+ + +-+-+ +-+ +-+ +-+-+ +-+ + +-+-+ +-+ +-+-+-+ +-+-+-+-+ + + + + + + +-+ + + + +-+-+ +-+
|     | |     | |   |       |     | |   | |   | |   | |   | |   | |   | |   |   | | | | | |   | |   |
+-+-+-+ +-+ +-+ + + +-+ + + + + +-+ +-+-+ +-+ + +-+-+ + + + +-+ + +-+ + + + + +-+ + +-+-+ + +-+ +-+-+
| | |           | |   | | |   | |       | |   |         | |         |     | |   |   |   | |         |
+ + + +-+ +-+ +-+-+-+ + +-+ +-+-+ +-+-+ +-+ +-+ + +-+-+ +-+-+-+ +-+-+ +-+-+ +-+-+ + + + + +-+-+ +-+ +
|   | |     |   | | |   |     |   | | |     |   | |   | | | | | |   |   | | | |   |   | |   |   | | |
+ + + +-+-+-+ + + + +-+-+ +-+ + +-+ + + +-+-+-+-+ + +-+-+ + + +-+-+ + + + + + + + +-+ +-+-+ +-+-+ + +
| |       | | |       |   |     |             |     | |   | |     |   | | |   | |   | |   | | | | | |
+-+ +-+ +-+ +-+-+ +-+-+-+-+-+-+-+ +-+-+-+-+ + +-+ +-+ + +-+ +-+ +-+ +-+-+ +-+-+-+ +-+-+ +-+-+ + + +-+
|     | |     |   | |       |   |     | |   |   |   |         |   |       |               |   |   | |
+-+ + +-+-+ + + + + + +-+-+-+ + + + +-+ + +-+-+ +-+ +-+-+ +-+ + +-+ +-+-+-+-+-+-+-+ +-+-+-+-+ + +-+ +
|   |   | | | | | |     |   | | | | |         | |     |   |     |   | |     |   |   |             | |
+-+ +-+-+ + +-+ + +-+ + + +-+ +-+-+-+ + +-+-+-+-+ +-+-+ +-+-+-+ + +-+ +-+ +-+ +-+-+ +-+-+-+-+-+-+ + +
|       | |     |     |           |   |   |     |         | |   | |     |     |     |         |     |
+-+ + +-+ + +-+-+ + +-+ +-+-+ + +-+-+-+-+ +-+ +-+ +-+-+-+ + +-+-+-+ +-+ +-+-+ +-+ +-+-+-+ + +-+ +-+ +
|   | |     |   | | | |   | | | |   |   | | |     | | |     | | |   | | | |               |     |   |
+ +-+ +-+ +-+ +-+-+ + +-+-+ +-+ + +-+ + + + +-+-+ + + + +-+-+ + + +-+ +-+ + +-+-+ +-+-+-+-+ +-+ +-+-+
|   |   |     |   |   |     |   |   | |   |         |   |       | |           | | |     |   | |     |
+-+-+ +-+-+-+ +-+ + +-+ + +-+-+ +-+ +-+ +-+ +-+ + +-+-+-+-+ + + + +-+-+ +-+ +-+ +-+ +-+ + +-+ + +-+-+
|     |   | |     |   | | | | | |     |     |   | |   |   | | |   |     | | |   |     | |   |   |   |
+ +-+-+-+ + + + +-+ +-+-+ + + + +-+ + +-+-+-+-+ +-+-+ + +-+-+ +-+ + +-+ + + +-+ +-+ +-+-+-+-+-+ + + +
| |     |   | |   |     |     |     | | |           |   |     |     |     |     |       | | |     | |
+-+ +-+ + +-+-+-+ +-+ + +-+-+ +-+ +-+ + + +-+-+-+ +-+ + + +-+-+-+ +-+ + +-+ +-+ + + + +-+ + +-+-+ + +
|   |   |     | | | | |   | | | | | | |   | |   |   | |   |       |   |   | | |   | |       |   | | |
+-+ +-+-+ + +-+ +-+ + + +-+ + + + + + + +-+ +-+ +-+-+ + +-+-+ + +-+ +-+ + + + + + +-+-+-+ + +-+ +-+ +
|   |     | | |   |   | | | | |     | | |   | |     | | |   | |   |   | | | |   |       | |   | | | |
+ +-+-+-+ + + + +-+-+-+ + + + + +-+-+ +-+ + + + +-+-+-+-+ +-+ + +-+-+-+ +-+ +-+ +-+-+-+ + + +-+ + +-+
|       | | | |     | |     |   |         |   |     | |   | | |   |   |   |   | | | |   | | | |     |
+ +-+-+-+ +-+ +-+ +-+ + + +-+-+ +-+-+ +-+ +-+ +-+-+ + + +-+ +-+ +-+ +-+ +-+-+ +-+ + +-+-+-+-+ + +-+-+
|     |   |         |   | |     | |   |   |                       |   | |       |   |       | |     |
+ + + + + + + +-+-+-+ +-+-+ +-+-+ +-+-+-+-+-+-+ +-+-+-+ + + +-+-+ + +-+ +-+-+ +-+ + +-+-+ +-+ + + +-+
| | |   |   |           |   |     | |     |   | |   |   | | |       |     |   |   | |       |   | | |
+-+-+ +-+ +-+-+-+-+-+-+ +-+-+ +-+-+ + +-+-+ +-+-+ +-+-+ +-+ +-+ +-+ +-+-+-+ +-+-+ +-+-+-+ + +-+-+ + +
|     |   |       |     |   | |   |     |   |   |       | | | |   |       | |     | |     |         |
+-+ +-+-+ +-+ + + +-+ +-+-+ + + + + +-+ + +-+-+ +-+-+ +-+ + + + +-+-+-+-+-+ +-+ + + +-+-+-+ +-+ + +-+
|     |     | | |   |     |     |   | | |     | | |       | | |   | |     |   | | | | | |   |   |   |
+ +-+-+-+-+-+ + + + + + + + +-+ + +-+ +-+ +-+-+ + +-+ +-+ + + + +-+ +-+-+ + +-+-+ + + + +-+ + +-+-+ +
| |           | | |   | |   |   | | |         | | | | | | | |         | |         |   | |   | |   | |
+ +-+ +-+ +-+-+ +-+ +-+-+-+-+ +-+ + + +-+ +-+-+ + + +-+ +-+-+ + + + + + +-+ +-+-+-+ +-+ +-+ +-+ + + +
| | | |   | |   |       |     | | | |   | |       |         | | | | |   | | |   | | | |     | | | | |
+-+ + +-+-+ +-+-+-+-+ + + + +-+ + + + + +-+ +-+ +-+-+-+ +-+-+ + +-+ + +-+ + +-+ + + + + +-+ + +-+ +-+
| |   | | |         | | | | |     |   |     |   |       |     |   | | |     | |     |   | |       | |
+ +-+ + + + +-+ +-+ + + +-+-+-+-+ + +-+-+-+ +-+-+ +-+ +-+-+ +-+-+-+-+-+ + +-+ + + + +-+ + + +-+-+-+ +
|     | | |   |   |   | |     |       |     |   |   |           |     | | |     | |   |   | |       |
+-+ +-+ + +-+-+-+ + + + +-+-+ + +-+ +-+ + +-+-+ + + + + +-+ +-+-+-+-+ + + +-+-+-+ +-+-+-+ +-+-+ +-+-+
| |   |     | | | | | | |   | |   | |   |   | |   | | | |       |     | | |           |   |     |   |
+ +-+ + +-+-+ + + +-+-+-+-+ + +-+-+-+-+ + +-+ +-+ + +-+-+ + +-+-+-+ +-+ +-+ +-+-+ +-+ +-+ + + + + +-+
|   | |       |     |       |     |     |   | | | |   | | |           |       | | | |     | | |   | |
+-+ +-+ +-+ +-+ + +-+-+-+-+ + +-+ + +-+-+ + + + +-+ +-+ +-+ +-+-+ + + +-+ + +-+ +-+ +-+ +-+ +-+ +-+ +
|         |     | |           | |       | | |     | |         | | | | |   |   |               |     |
+ +-+-+-+ + +-+ + + + + +-+-+ + +-+ +-+-+ +-+ +-+ + +-+-+ + +-+ +-+ + +-+ +-+-+ +-+ +-+-+-+ +-+-+ + +
|       | |   | | | | |     |   |       |     |   |   |   | |       | |       | |       |       | | |
+-+-+-+-+-+-+-+-+-+-+-+-+-+-+-+-+-+-+-+-+-+-+-+-+-+-+-+-+-+-+-+-+-+-+-+-+-+-+-+-+-+-+-+-+-+-+-+-+-+-+
