50
50
+-+-+-+-+-+-+-+-+-+-+-+-+-+-+-+-+-+-+-+-+-+-+-+-+-+-+-+-+-+-+-+-+-+-+-+-+-+-+-+-+-+-+-+-+-+-+-+-+-+-+
|     |   | |       |             |         |       |     | | |   | |       |   |       |         | |
+-+-+ + +-+ +-+ + + + + +-+-+ +-+ +-+-+-+-+ +-+ +-+-+ +-+-+ + + + + + +-+-+ + +-+-+-+ +-+-+ +-+ + + +
|         |   | | | | |     | | |       |           |   | | |   |         |   | |     | | |   | |   |
+-+ + +-+ + +-+-+-+ +-+-+ + +-+ + +-+-+ + + + +-+-+ + + + + +-+ +-+-+ +-+ + + + + +-+-+ + +-+ + +-+-+
| | | | |   |     |       |     | | |   | | |   | | | |       |   | | |   | |   |   |   | | | |   | |
+ + + + +-+-+-+-+ +-+-+ + +-+-+-+-+ +-+ +-+-+-+ + +-+ +-+-+-+ +-+-+ +-+-+ +-+ + +-+ + +-+ + +-+ +-+ +
|   |   |   | |     |   |   |       |   | | | |   |       |     |   | |     | |     |     |   |     |
+ + +-+ +-+ + +-+ +-+-+ + +-+ +-+-+-+ +-+ + + +-+ + + +-+-+-+-+ +-+ + + +-+-+-+ +-+ + +-+-+ +-+ +-+ +
| |   | |       |       | |   |     |       |     | |     |   | | |   |   |     | | |     | |     | |
+ +-+-+-+-+-+ +-+ +-+-+-+ + + +-+-+ +-+-+ + +-+-+ +-+-+ +-+ +-+-+ + +-+ +-+-+-+-+ + +-+ +-+ + +-+ + +
|     | | |     | |       | | |     |     |   | |         | | | |               |         |   |   | |
+ + + + + +-+ +-+-+ +-+ +-+-+ + +-+-+ +-+-+-+-+ + +-+-+-+-+ + + + +-+-+ +-+-+ + + +-+-+ +-+ + +-+-+-+
| | | |       | | | | | |     |   |     |           |   | | |   | | |     |   | | |   |     | |     |
+-+-+ + + +-+ + + + + +-+ + + + +-+ +-+-+-+-+ +-+-+ + + + + + + + + + +-+-+ + +-+-+-+ +-+ +-+-+ +-+-+
|     | | | | |       |   | |     |     |   |     | | | |   | | | | | |     |   | |     |     | |   |
+-+-+ + +-+ +-+ +-+-+-+-+ + + +-+-+-+-+-+-+ + + +-+ +-+ +-+ + +-+ + +-+ + +-+ +-+ +-+ +-+ +-+ + + +-+
| |     |   |       |   | | |     | | | | |   |   |             |   |   | |   | | |   | |   |     | |
+ + +-+ + +-+-+-+-+ + +-+-+-+ +-+ + + + + + +-+-+-+-+ +-+ +-+ + +-+-+-+-+-+ +-+ + +-+ + + +-+-+-+ + +
| | |     |     |       |   | |           |   |   |   |   |   | |   |   |       |         |   | |   |
+ + +-+-+ + + +-+ + + +-+-+ + + + +-+-+-+ +-+-+ +-+-+-+ +-+-+ +-+ + +-+ + +-+-+-+-+-+ +-+-+-+ + +-+ +
|     | | | |   | | |   |   | | | |     |   | |     | | |   |   | | |     |   | | |   | |           |
+-+-+ + +-+-+-+ + +-+-+-+ + +-+-+-+ +-+ +-+ + + +-+ + +-+ + +-+ + +-+-+-+ + +-+ + +-+ + +-+ + +-+ + +
|       | |       | |     | |         |   |   | | |   |   | |       |     |     |         | | |   | |
+-+-+-+ + + + +-+ + +-+-+ + +-+ + +-+-+ +-+ + +-+ +-+ + +-+-+-+ + + + +-+-+-+ +-+-+-+-+ + +-+-+-+ +-+
| |     | | | |           |     | |   |     |         |       | | |           |         |   |   |   |
+ + + +-+ +-+-+-+ + +-+-+-+-+-+ +-+ +-+ +-+-+ + +-+-+-+-+ +-+-+-+-+ +-+-+-+-+ +-+ +-+ +-+-+-+ +-+-+-+
|   |     |       | |         | |           | | |       | |     |       |       | |   |     |       |
+-+-+-+ + +-+-+-+-+-+ + + +-+-+ +-+ +-+-+ +-+ +-+ +-+ +-+ +-+ + +-+-+ +-+-+ + +-+-+-+ +-+-+ +-+-+ + +
|       |     |   |   | |   | |   |   |     | | | |   |   |   | |         | | |     |         |   | |
+-+-+-+ +-+-+-+-+ +-+ +-+-+-+ + +-+ +-+-+-+-+-+ +-+ +-+ +-+-+-+ +-+ + + +-+-+-+ +-+ + + + +-+-+ + +-+
|     | |     |     | | |   |   |   |   |   |       |   |       |   | |     | |   |   | |       |   |
+-+ +-+ + +-+-+ + +-+ + + +-+-+ + + +-+ +-+ +-+ + +-+ +-+-+ +-+ + +-+ + +-+-+ +-+ +-+-+-+-+-+ +-+-+ +
|             | | |       | | | | |   |     | | | | |       |       | | |       |   | |   | | |   | |
+ + + +-+-+ + +-+ + +-+ + + + + + +-+ + +-+ + +-+ + +-+-+ +-+ +-+-+ +-+ +-+-+ +-+-+-+ +-+ + + + + + +
| | | |     |         | | |     |   |   |         |     | | |   |   | |     | | | |       | | | |   |
+ +-+ +-+-+ +-+ +-+-+-+ + + + +-+-+-+ +-+ +-+ +-+ +-+ + +-+ +-+-+ +-+ +-+-+ + + + +-+ +-+ + +-+-+-+-+
| |       |   |   |   | | | | | |   |   |   |   |   | |   |   |       | |   |     |     |   | | | | |
+-+-+ +-+-+-+-+ +-+-+ + +-+ +-+ + +-+-+-+-+ + +-+ + +-+-+ + + +-+-+ +-+ +-+-+ +-+-+-+ + + +-+ + + + +
|         |     |     |   | | |     |   |   |   | | | |   | | | |       | |     | | | | |     |   | |
+ + +-+-+-+ + +-+-+ +-+-+-+-+ +-+ + + +-+ +-+ + +-+-+ +-+ + + + +-+-+ + + +-+-+ + + +-+-+-+ + + +-+ +
| |   | | | |     |             | | | | | |   | |   |     | | |   |   | |   |       |       |     | |
+ +-+ + + +-+-+-+ + + +-+-+-+-+-+ +-+ + + + +-+ + +-+ +-+-+-+ +-+ + +-+-+ +-+-+ + + + + +-+-+-+ +-+ +
|   | |   | |   |   | |   | |     |     | | | |           |     |   |       | | | |   | | |   | | | |
+-+-+-+-+ + + +-+-+ +-+ +-+ + +-+-+-+ +-+ +-+ + +-+-+-+-+ + + + + +-+-+ + +-+ + +-+ + + + +-+ + + + +
| | |       |             |       |           | |       | | | | | |     |   |   | | | | |   |     | |
+ + +-+ +-+-+-+-+ +-+ +-+-+-+-+ + + +-+-+ + +-+-+-+-+ +-+ +-+ +-+ +-+-+-+ + +-+ + + +-+-+-+ + + + + +
| |         |   | | | | |       | |     | | | |       |     |         | | |   |   |   | |     | |   |
+ +-+-+ + +-+-+ + + + + + +-+-+ + +-+-+ +-+ + + +-+-+-+-+ +-+-+ +-+ +-+ + +-+-+ +-+-+ + + +-+ + +-+ +
|     | |           | | | |   | |   | | | | |         | |       |           |       | |   |   |   | |
+-+-+ +-+ + +-+ +-+ +-+ + +-+ +-+-+ + +-+ +-+ +-+ + +-+ + +-+ +-+ +-+-+ +-+ + +-+-+-+-+ +-+-+-+-+ +-+
| |   | | |   |   | | | | |               |     | | | |   |     | |       | |     | |     |         |
+ +-+ + +-+-+ + +-+-+ + +-+-+-+ + +-+-+-+ + +-+ + +-+ +-+ +-+ +-+-+ +-+ +-+ + + +-+ +-+ + +-+-+ +-+-+
| |         | |   | |   |     | |     | |   |   | |     | | |   |   |   |     |     |   |   | | |   |
+ + +-+-+-+ +-+ + + + + +-+ + + +-+ +-+ + +-+ +-+-+ +-+-+ + + +-+-+-+-+-+-+ +-+ +-+ +-+-+-+ + +-+ + +
|     | |       |     |     | | | | |     |   |     |     |       |       | |   | |     |   | | | | |
+ +-+-+ +-+-+-+ +-+ +-+-+ +-+-+-+ +-+ +-+-+ +-+ + + +-+-+-+ +-+-+-+-+-+-+ + + + + +-+-+ +-+-+ + + + +
| |       | |     | |   | | |       | | |       | |   |   |     | |   |     | |   |               | |
+ +-+ + + + + + +-+ + +-+ + +-+-+-+ + + +-+-+ +-+ +-+-+ + + +-+-+ +-+ + +-+ +-+ +-+-+-+-+-+-+-+ +-+-+
|     | | |   | | |   |   |     |   | |       |       | |       | | |     | |   |     | | | | |     |
+ +-+ +-+-+ + + + + +-+-+-+-+-+ + + + + +-+-+ + + +-+ + +-+-+-+-+ + + +-+-+-+-+ + +-+-+ + + + + +-+ +
| |     |   | |   | |   |       | | | |     | | | |           |   | | |     |     | |   |   |   |   |
+-+ +-+ + +-+-+-+ +-+-+ +-+ +-+ +-+ +-+ +-+ + +-+ +-+ +-+ +-+ + + + +-+ +-+ +-+ + + + + + +-+-+-+-+ +
|   | | | |   |   |     | | |   |       | | |   | | |   | |   | |     |   | |   | | | | |           |
+ +-+ + +-+-+ +-+-+ +-+-+ + +-+ +-+-+ +-+ +-+-+ +-+ + + +-+-+-+ +-+-+-+-+ +-+ +-+-+ + +-+ +-+ + +-+ +
| |       |                 |   |   |     | |       | |   |     |       |   | |     |       | | | | |
+-+-+-+ +-+-+ +-+-+-+ +-+-+-+ + + +-+-+ +-+ +-+-+ +-+ + +-+ + + + +-+ +-+ +-+-+ + + +-+ +-+-+-+ + +-+
|   |   |     | |   |       | | |   | | | |       |   | |   | |   | | |         | | |         |     |
+ +-+-+ +-+-+-+ + + +-+ +-+ +-+ + + + +-+ +-+-+-+ + +-+ + + +-+ + + + + + + + + +-+ +-+-+-+-+ + +-+-+
|           | | | | |   |   |   | |   |     | | | | |     | |   | | |   | | | |   |     | |   |     |
+-+-+ +-+-+ + + +-+ +-+ +-+-+ + + +-+-+-+-+ + + +-+ + +-+-+ +-+ +-+ + +-+-+-+ +-+ + +-+-+ + +-+ +-+-+
|   |   |   | |   | |   | |   | | | |       |       | |   | |     |       | | |   |     | | | |     |
+ + +-+ + +-+ + +-+ + + + +-+ +-+ + +-+ +-+ +-+-+ + + +-+ +-+ + +-+ +-+-+ + + +-+-+-+-+-+ + + + +-+-+
| |     | |     |   | | | | |   |         |   | | | |       | |   |     | |   |       | |   | |   | |
+-+-+-+ + + +-+ +-+ + + + + + +-+ +-+ +-+ + + + + +-+-+-+-+-+ +-+-+-+-+ +-+-+-+-+ + + + + + + +-+ + +
| | |   |   |   |     | | |     | |   | | | |           |   |       |     |       | |   | |   | |   |
+ + +-+-+-+ +-+-+-+-+-+-+ + +-+ + + + + + +-+-+ + +-+ + + +-+ +-+ +-+-+ + +-+-+-+ +-+-+ +-+-+ + + +-+
|   |               |       |     | |   | | |   | |   | | |   | | |   | | |     |   | |     | | |   |
+-+ + +-+-+ +-+ + +-+-+-+-+ +-+-+-+-+-+-+ + +-+ + +-+-+ + + + + +-+-+ +-+ + + +-+-+-+ +-+-+ +-+ + +-+
|     | |   |   | |     |   |   | |       | |   |   |     | |   |   | | | | | | | |     |   | | |   |
+-+-+-+ + + + +-+-+-+-+ +-+ + +-+ +-+-+-+-+ + +-+-+-+ +-+-+-+-+ + +-+ + +-+ +-+ + + + +-+-+ + + +-+-+
|   |     | |   |   | |       |       |   |   | |   | |         |   |     | |     | |   |     |     |
+-+ + + + +-+ +-+ +-+ +-+ +-+-+ +-+-+ + +-+ + + + +-+ +-+-+-+ +-+ +-+-+ + + + +-+-+ + +-+-+-+ +-+-+ +
|     | |   |       |   | | |     |         | |         | |     |       |         | |     | |       |
+ +-+ +-+ +-+ + + +-+ +-+-+ + +-+-+ +-+-+ +-+-+ +-+ +-+ + +-+ + + +-+ +-+-+ + + +-+-+-+-+ + + +-+-+-+
| | |   | | | | |   |   |   | | |     | | | |   |     |   | | | |   |   |   | |   |   | | |       | |
+ + + + +-+ +-+-+-+ +-+ +-+ + + + + + + + + + + +-+ + +-+-+ +-+ + + +-+-+-+ +-+-+-+-+ + + + +-+-+ + +
| |   | |         | |       |   | | |   |   | | | | | | |     | | | | | |   |   |   | | |   |       |
+ +-+ +-+ + + + +-+ +-+-+-+ +-+-+ +-+ +-+-+ +-+-+ + +-+ + +-+-+-+-+-+ + + +-+-+ + +-+ + +-+-+-+ + +-+
|   |   | | | | |   |         |     |   |   |     |                     |   |           |   | | |   |
+-+ +-+ +-+-+ +-+-+ + +-+-+-+ + +-+ +-+-+-+-+-+ +-+ +-+-+ +-+ +-+ + + + +-+ + +-+ +-+ +-+ +-+ +-+-+ +
| | |     |     |     | |   |   |   |       | |   |     | |   |   | | |     | |   |     |     |     |
+ +-+-+-+-+-+ + + +-+ + + +-+-+-+-+ + +-+-+-+ + +-+ + + + +-+-+-+-+-+-+-+-+-+-+-+-+ +-+ +-+-+ + +-+-+
|       |   | |   |   |   | | | |     | | |   | |   | | |     | |   |         |       |   | |       |
+-+-+-+ + + +-+ +-+-+-+ + + + + + +-+ + + +-+ + +-+-+-+-+-+ +-+ + + + +-+-+-+ +-+ + + + + + + +-+ +-+
| | | | | | |         | |   |     | |   |                 |   |   | |   |       | | | | |       | | |
+ + + + +-+ + +-+-+ + +-+ +-+ +-+ + + + +-+ + + +-+ + + +-+ +-+ + + + +-+ +-+-+ + +-+-+ +-+ +-+ +-+ +
|               | | |   |   |   | |   |     | | | | | | |       | |   |   |     |     |   |   | |   |
+ +-+-+ +-+ + + + + + +-+-+ + +-+-+-+-+ +-+-+ +-+ +-+ + +-+-+-+ +-+ +-+-+-+-+-+ +-+ +-+-+ + +-+-+ +-+
|   |     | | |   | |       |   |       |     |       |       |   |       |             | |         |
+-+-+-+-+-+-+-+-+-+-+-+-+-+-+-+-+-+-+-+-+-+-+-+-+-+-+-+-+-+-+-+-+-+-+-+-+-+-+-+-+-+-+-+-+-+-+-+-+-+-+
