30
30
+-+-+-+-+-+-+-+-+-+-+-+-+-+-+-+-+-+-+-+-+-+-+-+-+-+-+-+-+-+-+
|     |   |   |     |   | |           | |   |       |       |
+ + +-+ + +-+ +-+-+ + +-+ +-+ +-+-+-+ + + +-+-+-+-+ +-+-+-+ +
| |   | |   |   |   |     |   |   |   |   |     | |   |     |
+-+-+ + + +-+ + + +-+-+-+ + + +-+ + + +-+ + + +-+ +-+ +-+ + +
|   | | |     |   |       | |   |   |     | | | | |       | |
+-+ + + +-+ +-+-+ + + +-+-+-+ + +-+ +-+-+ + + + + + + + + +-+
| | |   |     | |   | |   |   | |   | |     |   |   | | |   |
+ + +-+-+-+-+ + + + +-+ +-+-+ +-+-+-+ +-+ +-+-+ +-+-+-+-+-+ +
|       |     | | |   |     | |     | | |   |     |   |   | |
+ + + + + +-+ + +-+-+-+-+ +-+-+-+ + + + +-+-+-+ + +-+ + +-+ +
| | | |     | |   | | | |   |   | | |       |   |     |     |
+-+-+ +-+-+-+ +-+ + + + + +-+ + + + +-+ + +-+-+-+-+ + + + + +
|     |     |   |     |   | | |   | |   | |   | |   | | | | |
+-+-+ + + + +-+-+ + +-+-+ + +-+ +-+ +-+-+ + + + + + +-+ +-+ +
|       | | |     |   |           | |   |   | |   |   | |   |
+-+-+ +-+-+-+-+-+ +-+-+ +-+-+-+-+-+-+ +-+-+ +-+ +-+-+ + +-+ +
| |             |       |   |   | | | | |     |   | |   |   |
+ + + + +-+-+ + + +-+ + +-+ +-+ + + + + + +-+-+ +-+ +-+ +-+-+
| | | |     | |   |   | |       |     |   |   |   | |     | |
+ +-+-+-+-+-+-+ +-+-+-+-+ +-+-+ + +-+ +-+ + +-+-+-+ +-+ +-+ +
| | |   | | |       |       |     | | |           | |       |
+ + + + + + + +-+ +-+-+ + +-+-+-+ + +-+ +-+-+-+-+-+ + + + + +
|   | |   | | |     | | | | |   |     |   | | | |     | | | |
+-+ +-+ +-+ +-+ + +-+ +-+-+ + + + + +-+-+ + + + + +-+ +-+-+ +
| | | |       | | |   | |   | | | |     | |   |   | |     | |
+ + + + +-+-+-+-+ +-+ + + +-+-+ + +-+-+ + +-+ +-+ + +-+ +-+-+
|   |         |               |       | |       |     | |   |
+ +-+-+-+ +-+-+-+-+-+-+-+ + +-+-+-+ +-+ + +-+-+ + +-+-+ + +-+
| | |     |   |   |       |   | |   |       | | | |         |
+ + + +-+-+ +-+ + + +-+-+-+-+-+ + + +-+-+-+-+ + + +-+ + +-+-+
|         | |   |   |     |       |   |       | |   | | |   |
+-+ + +-+-+ + +-+ +-+ +-+ + + +-+ + + +-+-+-+ + + + +-+ + + +
|   |           | | | |   | | |   | |     |   |   |   | | | |
+ + +-+-+ +-+ + + + +-+ +-+-+ + + +-+-+ +-+ +-+ +-+-+-+-+ + +
| | | |     | | |     | |   | | | |   | |   | |   | | | | | |
+ + + +-+-+-+-+-+-+ +-+ +-+ + +-+-+ + +-+ + + + +-+ + + + +-+
| |   |     |         |     | |   | |   | |         | |   | |
+-+ + +-+ + +-+ +-+-+ +-+ +-+-+ +-+ +-+-+ + +-+ +-+-+ + +-+ +
|   |   | | |   |         | | |   |     | | |         |     |
+ + +-+-+-+ + + +-+-+-+-+ + + + +-+ +-+-+ + +-+-+-+-+ +-+ + +
| | | |       | |       |   | | | |     | |   |     |     | |
+ +-+ +-+ +-+-+-+-+-+ +-+ + + + + + + + + +-+-+ + + + +-+-+-+
|   |     | |   |     | | |     | | | | |   |   | | |     | |
+ + +-+ +-+ + +-+-+ + + + +-+-+ + +-+ +-+-+ + +-+ + +-+-+ + +
| |   |   |         | |       |         | |   |   |     |   |
+ +-+-+-+-+ + +-+ +-+ +-+-+-+ +-+-+-+ +-+ + +-+ + + + +-+ + +
|   |   |   | |     | |       | |     | | | |   | | |   | | |
+ +-+ +-+-+-+-+ +-+ +-+ + +-+-+ + +-+ + + + +-+-+-+ +-+-+-+-+
| |   |     | | |   | | | |         |   |     |           | |
+-+ +-+ +-+ + + +-+-+ + +-+-+ +-+ + +-+ + +-+-+-+-+ +-+ +-+ +
|   |     |             |   | |   |   |     | |       |   | |
+ + + +-+-+ + +-+-+-+ +-+ +-+-+-+ +-+-+-+-+-+ + + +-+-+-+-+ +
| |       | |   | |   |     |       | | |       |     | | | |
+ +-+-+ + +-+ + + + +-+ +-+-+ +-+-+ + + +-+-+-+ +-+ + + + + +
|     | |   | |   |   | |     |   | | |       | |   |   |   |
+ +-+ + +-+ +-+ + +-+-+ +-+-+-+ +-+ + + +-+ + +-+ +-+-+ +-+ +
| | | | |   | | |         |   |           | |   |   | |     |
+ + + +-+-+-+ +-+ +-+-+ + + + +-+ +-+ +-+-+-+-+-+ + + +-+-+ +
| |   |               | |   |   |   |         |   |     |   |
+-+-+-+-+-+-+-+-+-+-+-+-+-+-+-+-+-+-+-+-+-+-+-+-+-+-+-+-+-+-+
