40
40
+-+-+-+-+-+-+-+-+-+-+-+-+-+-+-+-+-+-+-+-+-+-+-+-+-+-+-+-+-+-+-+-+-+-+-+-+-+-+-+-+
|     |   | |   |       |   |       |         | |     |     | |   |       |   | |
+-+-+ + +-+ +-+ + +-+-+-+-+ + + + +-+-+-+-+-+ + +-+ + + +-+-+ + + +-+-+ + +-+ + +
|   |   |       |   |   |   | | | | | |   | | | |   | |   | |   |   |   | |   | |
+-+ +-+ +-+ +-+ + +-+ +-+ + +-+-+ + + +-+ + + + + +-+-+ + + + +-+ + +-+-+ +-+ + +
| |       | |   |     |   |   | | | |               | | |     | | | |     |   | |
+ + +-+-+ + +-+-+-+-+ + + +-+-+ + + + + +-+ +-+-+-+-+ +-+ +-+ + +-+ +-+ +-+ + + +
|     | | |   | |       |     |       |   | |   |   |       |   |   | |     |   |
+-+ + + +-+-+ + +-+ +-+-+-+-+ +-+ +-+ +-+-+ +-+ +-+ +-+-+-+-+ + +-+ + + +-+-+-+ +
|   | |     |         |         |   | |       |   | |   | |   |   |   |   |   | |
+-+ + + +-+ +-+-+ +-+-+-+-+ + + +-+ + +-+ +-+-+ + + + + + + +-+-+ +-+ +-+ +-+ + +
| | |     |     |   |   |   | |     |   |   | | |   | | |   | | |   |       |   |
+ + +-+ + +-+-+-+-+ +-+ +-+-+-+ +-+ +-+ + +-+ + +-+ +-+ + + + + + +-+-+-+-+-+-+ +
|   |   | |     | |   |         | | | | |         | |     | | |       | |     | |
+-+-+ +-+ + + + + +-+-+-+-+-+-+-+ + + +-+ +-+-+ + + + + +-+-+ +-+-+-+-+ + +-+-+-+
|   |   | | | |   | |   | |   |   |     | |   | | | | |                 |   |   |
+-+ +-+ +-+-+-+ +-+ +-+ + +-+ + +-+ + + +-+ +-+ + +-+-+-+ +-+-+ + +-+-+ + +-+ +-+
|               |       | |       | | |   |     | |       | | | | |             |
+-+ + +-+-+ +-+-+ +-+ +-+ +-+ +-+-+-+ +-+ + +-+-+-+ + + + + + + +-+ + +-+-+ + + +
| | |   | | | |   | |     |   |     | |   |       | | | | |     |   | |     | | |
+ + +-+ + +-+ +-+ + + +-+-+ +-+ + +-+-+-+ + + +-+ +-+ +-+ +-+-+ + +-+-+ +-+ + +-+
|   |     |     |   |     | | | |         | | |   |   |   |     |     | |   |   |
+-+ +-+ + +-+ +-+-+ +-+-+-+ + + +-+ +-+ + +-+ +-+-+-+ + + +-+-+ +-+-+-+-+ +-+-+-+
| | |   |       |   |         | |   |   | | |   |     | | |   | |   |   | |     |
+ +-+-+-+ + +-+-+-+ +-+ + + +-+-+-+ + + + + +-+ + + + +-+ + +-+ + +-+ +-+-+ +-+-+
|       | |   |     |   | |     | | | | | |   | | | |   | | | |     |   |       |
+ +-+-+ + +-+ +-+ +-+-+ +-+ +-+ + +-+-+ +-+ + +-+-+ +-+ +-+ + +-+ + + +-+ +-+-+ +
|   |   | | |   |     |   | |         | | | |       |         |   | |       | | |
+-+ + +-+-+ + +-+ + +-+ +-+-+ +-+-+-+-+ + + + +-+-+-+ +-+ +-+-+-+-+ +-+-+ +-+ + +
|   | | |       | |   | | | |           | | | |     | |       |   | |     |   | |
+-+ +-+ + + +-+-+ + +-+-+ + +-+-+-+ +-+ + + + +-+ + +-+-+-+ +-+-+ +-+-+-+ +-+ +-+
|         |   |   | |     |         | |   | |   | |   |     |     | |   |       |
+-+ +-+-+-+-+ + + +-+ +-+ + +-+ + +-+ +-+-+-+-+-+-+ + + +-+-+-+-+ + +-+ + + +-+ +
| |   |         | |     |   |   |   | | |       | | |   |   |     | |     |   | |
+ + +-+-+-+-+-+-+ + +-+-+-+-+ +-+ +-+ + +-+-+ +-+ +-+ + + + +-+-+ + + +-+-+-+ +-+
| | |     |         |   |   |   | |   |         | |   | | |             |   | | |
+ +-+ +-+-+-+ +-+ + + +-+ +-+ +-+-+ + +-+-+-+-+ + + + + +-+-+ + +-+-+ + + +-+ + +
|     |     | | | | | |   | |   |   |     |   | |   | | |     |     | |   | |   |
+ +-+ + +-+ + + + +-+ +-+ + +-+-+-+-+ + + + + + + +-+-+ +-+-+ +-+ + +-+-+ + + +-+
|   |   | |   |   |     |   |     |   | |   | |       | |     |   |     | | |   |
+ +-+ +-+ +-+-+ +-+-+-+ +-+ + +-+-+-+ +-+-+ +-+ + + +-+-+ +-+-+-+-+ +-+-+-+ +-+-+
| | |     |       |     |   |     |       | | | | | |     |       |   | |       |
+-+ +-+-+ +-+-+ +-+ + +-+-+ + +-+-+ + +-+-+-+ + +-+-+-+ + +-+-+-+ +-+-+ +-+-+ + +
|   |     |   |     |     | | |   | |     | |     |     |       | |   |   |   | |
+ + + + + +-+ + +-+ +-+ +-+ + +-+ + +-+ +-+ + + + +-+-+-+-+ +-+ + + +-+-+ + +-+-+
| |   | |   |   |   | |   |     |   | |   | | | |   |   | | |   |     |     |   |
+-+-+ +-+-+ + +-+ + + + +-+-+ +-+ + + +-+ + +-+ +-+ + + + + +-+ + +-+ + +-+-+ +-+
|         | |   | |   |     |     |   |   |       | | |       |   |     |   |   |
+-+-+-+ +-+-+ +-+-+-+-+ +-+ +-+ + +-+ +-+ +-+ + + +-+ +-+-+ +-+-+ +-+-+ + +-+ +-+
|       |   | |     | |   |   | |   | | |     | |   |     | |     | |           |
+-+-+-+ + +-+ + + +-+ +-+-+-+ +-+-+ +-+ +-+ + + + + +-+ +-+ + +-+-+ + + +-+ +-+-+
|     | |     | |   |     |     | |     |   | | | | |     | |   |     |   | |   |
+ +-+ +-+ +-+ +-+-+ +-+-+ +-+ + + +-+ +-+ +-+-+-+-+-+ + +-+-+ + +-+ + +-+-+-+ +-+
|   | |     |   |     |   | | | | |   | |   |   | | | | | | | | | | |   |     | |
+ +-+ + +-+-+-+-+-+-+ + + + +-+ + + +-+ + +-+ + + + +-+ + + +-+-+ +-+ +-+-+-+ + +
| |             |   |   | |       | |         |         | |   | |   |   |       |
+-+ +-+ +-+-+-+ +-+ + +-+-+-+-+ +-+-+-+ + + + +-+ +-+ + + +-+ + +-+ +-+ + +-+ +-+
| |   |       |           |             | | |   | |   | | |   |     |     | |   |
+ +-+ +-+-+-+-+-+-+ + +-+-+-+ +-+ +-+ + + + +-+ +-+-+ +-+ +-+ +-+ +-+-+ + + + + +
|       | |   |   | | |     |   | |   | | |   |     | | |   |   |       | |   | |
+-+-+-+ + + +-+ + + + +-+ + + +-+-+-+ + +-+-+ +-+ +-+-+ + + +-+ +-+ + +-+ +-+-+ +
| | |         | |   | |   |     | |   | | | |   | |       |     |   | |   |   | |
+ + + +-+ +-+-+-+-+ + +-+ + + +-+ +-+ +-+ + +-+ +-+-+-+ +-+ +-+ + + +-+ +-+ +-+ +
|       |         | | |   | |   |     |   | | |   | | | |   |     | |         | |
+-+-+ +-+-+-+-+-+-+ +-+-+-+ + +-+ +-+ + +-+ + +-+-+ + +-+-+-+ +-+ + + +-+ + +-+ +
| | | |         | | |   |   | |   |       |   |     |   |   |   | | | | | | | | |
+ + +-+ +-+-+ +-+ +-+-+ +-+ + +-+-+ +-+-+ + +-+-+ + + +-+-+ + + + + +-+ +-+ + + +
|     | | |         |       |   |   |     |   |   |   |   | | | | |   | |   | | |
+ +-+-+-+ +-+-+ +-+-+-+ +-+ +-+ +-+ + + + +-+ +-+-+ + +-+ + + + + +-+-+ + + + +-+
|     |             |     | |   |   | | | | | | |   |   |     | | | | |   | |   |
+ + + + + +-+ +-+ +-+-+ +-+-+ + +-+-+-+-+ + + + +-+ +-+-+-+ +-+-+ + + +-+ +-+ +-+
| | |   | |   |   | |   |     |       |   | |   |       |   |     | | |   |     |
+-+-+-+ +-+-+ + +-+ +-+ + + +-+-+ + + +-+-+ + +-+ +-+ +-+-+-+-+-+ + + + +-+-+-+ +
| |       | | |     | | | |   | | | | | |     |   |   | | |       |   | |       |
+ + +-+-+-+ +-+ +-+-+ +-+-+ + + +-+-+ + +-+-+ +-+ +-+ + + +-+ +-+ + +-+-+-+ +-+ +
|     |     |       |   |   |     |     |   |     | | |       | |   | | |     | |
+-+ + + +-+ +-+-+ + + +-+-+ +-+-+ +-+-+ +-+ +-+-+-+ + +-+ +-+ + +-+ + + + + +-+-+
| | |   | |   |   |       |     |     |     |       |     |   | | |     | |     |
+ + + +-+ + +-+ + + +-+-+-+-+ + + +-+ +-+-+ + +-+ + +-+-+-+-+ + + + + + + + +-+ +
|   |     | |   | |           | | |     |       | |   |           | | |   | |   |
+-+-+-+-+-+-+-+-+-+-+-+-+-+-+-+-+-+-+-+-+-+-+-+-+-+-+-+-+-+-+-+-+-+-+-+-+-+-+-+-+
