50
50
+-+-+-+-+-+-+-+-+-+-+-+-+-+-+-+-+-+-+-+-+-+-+-+-+-+-+-+-+-+-+-+-+-+-+-+-+-+-+-+-+-+-+-+-+-+-+-+-+-+-+
|   |           | |     |   |         |       | |     | |   |   |     |   | |         |     | | |   |
+-+ +-+-+-+-+ +-+ + + +-+ +-+ +-+ +-+-+-+ + +-+ +-+ +-+ + + + +-+ +-+ + + + + +-+ + +-+-+ + + + +-+ +
| |     | | |       | |   |   |   |       |     |     | | |     |   | | |     |   |       | |   | | |
+ + +-+-+ + +-+-+-+-+ +-+ + +-+ +-+-+-+-+-+-+ + +-+-+ + + + +-+ + +-+-+-+-+ +-+ +-+ +-+-+ +-+ +-+ + +
|           | | |       |   |     |         | | |   |     | | |     |     |   | |   | | | | |   |   |
+-+-+ +-+ +-+ + +-+-+ +-+ + + +-+ + +-+-+ +-+ +-+ +-+-+ +-+ + + +-+-+-+ +-+ +-+-+-+ + + +-+ + +-+ +-+
|     | |             |   | | | |     | | |     | | |   |   | |   | |     |       |   |     |       |
+ +-+-+ + +-+ +-+-+-+ +-+-+-+ + +-+-+ + +-+-+ +-+ + + +-+-+-+ +-+ + + + +-+-+-+ + +-+-+ +-+-+-+ +-+-+
|   |   |   |   | |         |   |   |   | |               | |   |   | |     |   |     |   |   |     |
+ + +-+ +-+ + + + +-+-+ +-+ + +-+ +-+ +-+ + + +-+-+-+ +-+ + +-+ + +-+-+-+ +-+-+-+-+ +-+ +-+-+ + +-+ +
| | |   |   | | | |       | |       | |     |   |   |   | | |     |   | |     |     |   |         | |
+ +-+-+ +-+-+ +-+ +-+-+ + +-+ +-+ + +-+-+ +-+ +-+-+ +-+-+-+ + + +-+-+ + + +-+-+ +-+-+-+ + +-+ +-+ +-+
| | |     | |   | |   | | | |   | | | |   | |     | |       | |     | |     | |   | |       | | | | |
+-+ +-+ +-+ + +-+ +-+ + +-+ + + + +-+ + +-+ + +-+-+ + +-+ + +-+ + +-+ + + +-+ + +-+ + +-+ + + + +-+ +
| |     |           |   |     | |       | |       |     | | |   | |     | | |       |   | | |     | |
+ +-+ +-+-+-+ +-+-+-+-+ +-+-+-+ +-+-+ +-+ +-+-+ +-+ +-+ +-+-+-+-+ + +-+-+-+ +-+ +-+ +-+ + +-+ +-+ + +
| |     |     | |   |   | |   | | | |     | |   |   |   |     |               | |       |   | |   | |
+ +-+-+ + +-+-+ + +-+-+ + + +-+-+ + + +-+ + +-+-+ +-+ +-+-+ + + + +-+-+ +-+-+-+ +-+-+ +-+ + +-+-+ + +
| |     | | | |         |   |   |     | |           | | |   | | |   |     | | | | |     | |     |   |
+ +-+ + +-+ + + +-+-+ +-+-+ + + +-+ + + + +-+-+ + +-+-+ + +-+-+-+-+-+ + + + + + + +-+ +-+-+ +-+-+ +-+
|     |   |     |   | | | | | |   | |   | | | | | | |   |       |     | | |   | | | |     |     |   |
+ +-+ +-+-+ +-+-+-+ + + + + + + + + + +-+-+ + +-+ + +-+ +-+-+ +-+-+-+-+ + +-+ + + + + + + +-+ +-+-+ +
| |   | | | |   |   |       | | |   |   |   | | |       | |   |         | |   |   |   | | |   |   | |
+ +-+ + + +-+-+ + + + +-+-+-+-+-+ +-+-+-+ +-+ + + +-+-+-+ +-+ +-+-+ + +-+-+ + + + +-+ +-+-+ +-+ + +-+
|   |             | | |     |   | | |   |       | |   |   | | |   | |   |   | | |   | |         | | |
+-+ + + +-+ +-+-+-+ + + + +-+-+ + + +-+ + +-+-+ + + + + + + + + +-+-+ +-+-+ +-+-+-+-+ + + +-+-+ + + +
|   | | | |       | |   |     |     | |   |   | |   |   | | |   |   |   | | |     |   | |     | |   |
+ +-+ + + +-+ + +-+-+ + + +-+-+-+ +-+ +-+-+-+ + +-+-+-+ + + + + + +-+-+ + + + +-+-+ +-+ +-+ +-+-+-+-+
|   | | |   | |     | | |                     | |   |   |   | | |   |   |   | | | |   | |   | |     |
+-+ + +-+ +-+-+ +-+-+-+-+ +-+-+ +-+ +-+-+-+ + + + +-+ +-+ +-+ +-+ +-+ +-+ + + + + +-+-+-+ +-+ +-+ +-+
|   |   |       |           | | |   |   |   | |     | |   |   | | | | |   |   | | | |   | |       | |
+-+-+ +-+-+ + +-+-+-+-+ + +-+ + +-+ + +-+-+-+-+-+-+ + +-+-+-+ + + + +-+ +-+-+-+ + + + +-+ +-+-+ +-+ +
|     | | | |   |       |   | | | |         |     |   |   | |     | | |     |   |   |   |           |
+-+ + + + +-+-+-+-+ +-+-+-+ + + + + + + + +-+-+ +-+ +-+ + + + +-+-+ + + +-+-+ +-+-+ +-+ + +-+ + +-+ +
| | |   | | |       |     | |   |   | | |   |   | |   | |   | | |             | |   | |   |   |   | |
+ + +-+ + + + +-+ +-+-+ +-+-+ +-+ +-+-+ + +-+-+ + + +-+-+ + + + + +-+-+ + +-+ + +-+ + + +-+-+ +-+ +-+
|   | |         |   |       | |   | | | |   |     |   |   |   | | |   | | |   |       |   |     |   |
+-+-+ + +-+-+ +-+-+ + +-+ +-+-+ + + + +-+-+ + +-+-+-+ + +-+-+-+ +-+-+ + +-+-+ + + +-+-+-+-+-+ + +-+-+
|       | |       |     | | |   |         | |   | |             |     | |       |   |         | | | |
+ +-+ + + +-+-+ + + +-+ + + + +-+-+-+ + + +-+ + + + + +-+-+-+-+ +-+-+ +-+-+-+-+ + +-+-+-+ + +-+ + + +
| | | | |       | |   | | |   |   |   | |     |   | |   | |   |       |   |     | | |     |   |   | |
+-+ +-+ +-+ +-+-+ +-+-+-+ +-+-+-+ + +-+-+-+ +-+ +-+ +-+ + + +-+-+ + +-+ +-+ +-+-+ + +-+ +-+-+-+-+-+ +
| |       |   | | | |     |   |   | | | |   |   | | | | | |     | |   | |       | |   |   |   |     |
+ + +-+-+-+-+-+ +-+ +-+-+-+ +-+ +-+ + + +-+ +-+-+ +-+ +-+ + +-+ +-+-+ + +-+-+ + +-+-+ + +-+ +-+ +-+-+
|   |     | |   | |   |     | | | | |         |   |   |   | |     |     | |   |       |     |       |
+ + +-+-+ + + + + +-+ +-+-+ + + + +-+-+ + +-+ +-+ +-+ + +-+-+ +-+-+-+ +-+ + +-+-+-+-+-+-+ + + +-+-+-+
| | |   | |   | |   |   |   |       | | | | | | | | |     | |   | | |   | |     |     | | | | | |   |
+-+ +-+ + +-+-+ +-+ + +-+-+ +-+ +-+-+ +-+ + +-+ + + +-+-+ + + + + + + +-+ +-+-+ +-+-+ + +-+ + + + +-+
| | | |     |         |     | |     |   | |           |       |         |     |               | | | |
+ +-+ + +-+ + + +-+-+ +-+ +-+ + +-+-+-+ + +-+-+-+-+-+ +-+-+-+ +-+-+ + +-+ +-+-+-+ +-+-+ +-+ +-+ + + +
|   |     | | |   | |         |   | |         |     |       |     | |     | | | | | |   | |         |
+ +-+-+-+-+ + + +-+ +-+-+-+ +-+-+ + + + +-+-+ + +-+ + + +-+-+ +-+ + +-+ +-+ + + + + + + + + + +-+-+ +
|     | | | | |   |       |       | | | | | | |   |   | |   | | | |   |             | |   | |   |   |
+-+ +-+ + + + +-+ + +-+-+-+ +-+-+-+ + +-+ + + + +-+ +-+-+ + +-+ + + + +-+-+-+ +-+-+ + + + +-+-+ +-+-+
| |       |     |   |                 |         |   |   | | |   | | |       |     | | | | | |       |
+ + +-+ +-+-+ + +-+ +-+-+-+ + +-+-+-+-+-+-+ + +-+-+ + +-+-+ + +-+-+-+ + +-+ +-+ +-+-+-+ +-+ +-+-+-+-+
|     | |   | | |     |   | |     | | |   | |   | | |       | |       | | | | |     | | | |         |
+ + +-+-+ + + +-+-+ + + +-+-+ + + + + +-+ + +-+-+ + + + +-+-+ + +-+-+-+-+ + + + +-+ + +-+ + +-+ +-+-+
| |       |   | | | | |     | | |     |   | |       | |       |   | | |   | |     |   |       |     |
+ +-+-+ + +-+-+ + + +-+ + +-+-+-+ +-+ +-+ +-+-+-+-+-+ + +-+ + +-+-+ + + + +-+-+-+-+ +-+ +-+ +-+-+-+ +
|   |   | | |     | |   | | | |   |     |   |         | |   |     |   | | |           |   |   | |   |
+-+ +-+-+ + + + +-+ +-+-+ + + + + + + + + +-+-+ +-+ + +-+-+ +-+-+ + + + +-+ +-+ + + +-+-+-+-+ + +-+-+
|   |     |   | |     | |   |   | | | |         | | |     |     | | |   |     | | | |   |   | |     |
+-+-+-+ + + + +-+-+-+ + +-+ +-+-+-+ +-+ +-+ +-+ + +-+-+ +-+ + + +-+ +-+-+ +-+-+ +-+-+-+ + +-+ + + +-+
| | |   | | | | |             |   | |   | |   |   |       | | | |       | | |           |       | | |
+ + +-+ +-+ +-+ +-+-+-+ + +-+-+-+ +-+-+ + +-+ +-+-+-+ +-+ + +-+-+ +-+-+ +-+ +-+-+ +-+-+-+-+ +-+-+ + +
|   | | | | | |       | |     | |   |   |     |         | | |   | |   |     | |   |     |   | | | | |
+-+ + + + + + +-+-+-+ +-+ +-+-+ + + +-+-+-+-+-+-+ +-+-+-+-+ + +-+ +-+ +-+-+-+ + +-+ +-+ +-+ + + +-+ +
|   |       | |   |     |   |     |   | |   |   | |     | | |       | |   |   | |     |             |
+-+ + +-+ +-+ +-+ + +-+-+-+ +-+ + + + + + + + + + +-+ +-+ +-+ + +-+-+ +-+ + + + + + +-+ + +-+ +-+-+-+
|       |       | |     | |   | | | | |   |   |               |   |   |     | |   | |   | |       | |
+-+-+-+-+-+ +-+ + + +-+-+ + + +-+-+ + + + +-+ +-+-+-+ + +-+-+ + +-+ +-+ +-+-+-+-+ +-+-+ +-+ +-+-+ + +
|       | | | |   | | |   | |   | | |   |   |       | |     | |             | | | | |   | | |       |
+-+-+ +-+ +-+ + +-+ + +-+ +-+-+ + +-+-+-+-+-+-+-+ + +-+-+ +-+ + +-+ +-+-+-+-+ + +-+ + +-+ + + + +-+ +
|   |   | |     |   |           |   | | |         |     |   | |   |       | |   | | |   | | | |   | |
+ +-+-+ + +-+ +-+ +-+ + +-+ + +-+-+ + + + +-+-+ +-+ + + + +-+ + + +-+-+ + + +-+ + + +-+ + +-+-+ +-+ +
|     |   |     |     |   | |     |       | | | |   | | | | | | | |     |       |   | |   |     |   |
+-+-+ + + +-+ +-+ +-+-+-+ +-+ +-+-+ +-+ + + + + + + +-+-+-+ +-+ + + +-+-+ +-+-+ + + + +-+ +-+-+ +-+-+
|     | |     | |     |   | |     |   | | |     | | | | |       | | |   |     |   |     |   |     | |
+-+ + + +-+-+ + + + + +-+-+ + +-+-+-+-+-+-+-+-+ +-+ + + + +-+-+ + +-+-+ + +-+-+-+-+-+ + +-+-+ +-+ + +
|   |   |     | | | | |         |       | |   | |   |     |     |     | |   |   | | | |   | | | |   |
+ +-+ + +-+ +-+ +-+-+-+-+ +-+-+ + +-+-+ + + + + +-+ +-+-+ +-+-+ + +-+-+ +-+-+ +-+ + +-+-+-+ +-+ + +-+
| | | | | | |     |     | |       |     |   | | |   | | | |     | | | |     | |   |   |         |   |
+-+ +-+ + + + +-+-+ + +-+-+ + +-+-+-+-+-+-+ +-+-+ + + + +-+ + +-+ + + +-+ +-+ + +-+ + +-+-+-+ +-+ +-+
|     |   |     |   | |     |       |           | |       | | |   |   | | |       | |     |   |     |
+-+ + +-+-+ + +-+ +-+ +-+ + + +-+-+-+-+-+-+-+ +-+-+-+ + +-+-+-+ +-+ + + + +-+-+ +-+-+-+ +-+-+ + + +-+
|   | |     |   |   |   | | |   | |           |   |   |     | |     |   | |       | | | | | |   |   |
+ + + +-+ +-+ +-+-+ + + + +-+ + + + +-+ +-+-+ +-+ +-+-+ +-+ + + + +-+-+-+ + + + +-+ + + + + +-+-+-+-+
| | |       | | | | | |     | |     |   | | |   |         | |   |           | |   |   |   | |       |
+-+ +-+ + + + + + + + + +-+ + +-+ + + + + + + + +-+-+-+ +-+-+ +-+ +-+-+ +-+-+ +-+-+-+ + +-+ + +-+ +-+
|     | | | | |   | | | |   | |   | | |   |   |     |     | | |   |   | | |             |     |     |
+ + +-+-+-+-+-+ + +-+-+-+ + +-+-+-+ +-+ +-+-+ +-+ + + +-+-+ + + + + +-+-+ + +-+ + + + +-+ +-+-+ +-+-+
| |   | | | |   |         | |   | |   | |   | |   | |   |   | | |         |   | | | |   | | |       |
+-+ + + + + + + +-+-+ +-+-+ +-+ + + +-+ + + +-+-+ +-+ +-+-+ +-+-+-+-+-+-+-+ + + + +-+ +-+-+ + + +-+ +
|   | | |     | |       |   |       |     |     | |                 |   |   | | | |   | |     |   | |
+-+ +-+ +-+ +-+-+-+ +-+-+-+-+ +-+ +-+-+ + + +-+-+-+-+-+-+ +-+-+-+-+-+-+ + + +-+-+ +-+-+ + +-+ +-+-+-+
| | |   | | | | |       |       |     | | | |   |   |     |     |   |   | |   | |   |     |     |   |
+ + + +-+ + + + +-+ +-+ +-+-+ +-+ +-+ +-+ + +-+ + + + + +-+-+ + +-+ +-+ + + +-+ +-+-+ + +-+-+ + +-+ +
|   |       |         |   |     | |   |   |       | | |       | |         |           | |     |     |
+-+-+-+-+-+-+-+-+-+-+-+-+-+-+-+-+-+-+-+-+-+-+-+-+-+-+-+-+-+-+-+-+-+-+-+-+-+-+-+-+-+-+-+-+-+-+-+-+-+-+
