15
12
+-+-+-+-+-+-+-+-+-+-+-+-+-+-+-+
|   |   |     |   |           |
+ +-+ +-+ +-+-+ +-+ +-+-+-+ +-+
|     | | | | | | |     |     |
+-+ +-+ + + + + + +-+-+ + +-+-+
|   |   |   |     | |   |   | |
+ + +-+ +-+ +-+-+ + + +-+-+-+ +
| |             | |   |       |
+-+-+ +-+ +-+-+ + + +-+-+-+-+ +
|     |   |     |           | |
+ +-+ +-+ +-+-+-+-+ +-+-+ +-+ +
| | |   | |   |     |     |   |
+-+ +-+ + + + + + +-+ +-+-+-+ +
|   |   | | |   | |       |   |
+-+ + +-+-+-+-+ + +-+ +-+ + +-+
| |     |     | | |     |     |
+ +-+ +-+ +-+ + +-+-+ +-+ + +-+
| |       |     | |   |   | | |
+ + + +-+-+-+-+ + + +-+-+-+-+ +
|   |         | |   | | |   | |
+-+ +-+-+-+-+ +-+-+-+ + + + + +
| | |               |     | | |
+ + +-+ + + +-+-+-+-+ + +-+-+ +
|     | | |           |       |
+-+-+-+-+-+-+-+-+-+-+-+-+-+-+-+
