15
12
+-+-+-+-+-+-+-+-+-+-+-+-+-+-+-+
|     | |     |               |
+ +-+-+ + + + +-+-+ +-+ +-+-+-+
|     | | | |     |   | |     |
+ + +-+ + + + + +-+ +-+ +-+ + +
| |     | | | |     | | |   | |
+ + + + + +-+-+ +-+ + + + +-+-+
| | | |   | |     | |         |
+ + +-+-+ + +-+ + + + + +-+ + +
| |   |   | | | | | | |   | | |
+-+ +-+-+-+ + + +-+-+-+ +-+ +-+
|     |     |   |     |   |   |
+ + +-+ +-+-+-+ + + +-+-+ +-+-+
| | |       |     | |         |
+-+-+-+ +-+-+-+-+ + +-+-+-+ + +
| |   |     |     | |   | | | |
+ +-+ + + +-+-+ + + + + + +-+-+
|     | |     | | |   |     | |
+-+-+ +-+ + + +-+-+ +-+ +-+ + +
|   |   | | | |   | |   |   | |
+ + + +-+ +-+ + + + +-+ +-+-+ +
| |   | |   | | |   |     |   |
+ + + + + +-+ + +-+ +-+ + + +-+
| | |       |     | |   |     |
+-+-+-+-+-+-+-+-+-+-+-+-+-+-+-+
