15
12
+-+-+-+-+-+-+-+-+-+-+-+-+-+-+-+
|         |       | |         |
+-+-+ + +-+-+ + +-+ +-+ + +-+-+
|     | |   | |     |   |     |
+-+-+ +-+ +-+-+-+-+ +-+-+-+-+ +
| | |       |       | |   |   |
+ + +-+-+ +-+-+ + +-+ +-+ + +-+
|     | |     | |   |   |     |
+-+-+ + + + +-+-+ +-+ +-+ +-+ +
|         | |   |       | |   |
+ +-+-+-+-+ + + +-+-+-+ +-+-+ +
|   |       | | | |           |
+ + +-+-+ + +-+ + + + +-+-+-+-+
| |   | | |         |     | | |
+-+ +-+ + +-+-+-+-+ +-+-+ + + +
|   |     | |   |       |     |
+-+ + +-+ + +-+ + +-+-+-+-+ + +
| | | | | |           |     | |
+ + +-+ +-+-+ + +-+ + +-+-+-+ +
|   |     |   |   | | |   |   |
+ +-+-+-+ + + + + + +-+-+ + + +
|   | |     | | | | |     | | |
+ +-+ +-+-+-+ + +-+ + +-+ +-+ +
|           | |   | |   |     |
+-+-+-+-+-+-+-+-+-+-+-+-+-+-+-+
