30
30
+-+-+-+-+-+-+-+-+-+-+-+-+-+-+-+-+-+-+-+-+-+-+-+-+-+-+-+-+-+-+
|   |         |   | | |       |     |   |         |         |
+-+ + +-+-+ +-+-+ + + + +-+-+-+ +-+-+ +-+-+ +-+ +-+ + +-+-+-+
|     |     |       | |   |   |           | |       |       |
+ + + +-+-+ +-+ + +-+ + +-+ + + + +-+-+ +-+-+ + + +-+-+-+-+-+
| | | |   | |   | |       | |   | | |   |     | | |   |     |
+-+ +-+-+ +-+ +-+-+-+-+ + + + +-+-+ +-+ + + +-+-+-+ +-+ +-+ +
|   |           |       | | |   |     |   |   | | |   | |   |
+ + +-+-+ +-+ + +-+ + + + +-+ +-+-+ + +-+-+-+ + + +-+ +-+ + +
| |       |   |     | | | |       | |     |   |     | |   | |
+ + + + +-+ + +-+ + +-+-+ +-+ +-+-+ +-+-+-+-+ + + + + + +-+-+
| | | |   | | |   |   |         |   | | | |     | |     |   |
+ + +-+-+-+-+ +-+ +-+-+ + +-+ +-+-+ + + + + +-+-+-+-+-+ +-+ +
| |       |   | | |   | | |   | | |         |           |   |
+ +-+-+-+ +-+-+ +-+-+ + + + +-+ + +-+-+-+-+ + +-+-+-+-+ +-+ +
|     |     | |   |   | | | |     | | | |   |         |   | |
+-+ + +-+ +-+ + +-+-+ +-+-+ + + +-+ + + +-+-+-+ + +-+-+-+-+ +
|   | |   | |     | | |       |   |   |     |   | |   |   | |
+-+ +-+-+-+ + +-+ + + + +-+-+-+-+ + +-+-+-+ +-+ + + + + + + +
| |   | |   |   | |   |       | |     |   | |   |   | | |   |
+ +-+ + +-+ + +-+ + +-+ + +-+-+ + + +-+ +-+ +-+ + + + +-+ +-+
|     |       |     |   | | |   | |     | | | | | | |     | |
+-+-+-+-+ +-+-+ +-+ +-+-+ + + +-+ + +-+-+ + + + +-+ +-+-+ + +
|   |       |   | |   |     | |   | |       |   |       |   |
+-+ +-+-+ +-+-+-+ +-+ + + +-+ +-+ + +-+ +-+-+-+-+ +-+-+-+-+-+
|   | |     |     | |   |     | | |     | | | |             |
+-+ + +-+-+-+-+-+ + + + + +-+-+ +-+ + + + + + +-+-+ +-+-+ +-+
| | |   |       | | | | |   |   | | | | | |       |     | | |
+ + + +-+-+ + +-+ + + +-+-+ +-+ + +-+ +-+ + +-+-+-+-+ +-+ + +
|   |     | |   |     |       |     | |   |       | | | |   |
+-+ +-+-+ + + +-+ +-+ +-+ +-+-+-+ +-+ +-+ + +-+ +-+ + + + +-+
|   |     | | | | | | | |     |     | | | | | |         |   |
+ +-+ +-+ +-+ + +-+ + + +-+-+-+ +-+-+-+ + + + + +-+-+-+-+ + +
| |     |     | |       | |         | |   |   |   |   | | | |
+ +-+ +-+-+-+-+ + +-+-+ + + + +-+-+-+ +-+ + +-+ + + +-+ +-+ +
| | | |   |   | |     | |   |   |     |       | |         | |
+ + + + + + + + + +-+ +-+-+ + +-+ + + + + + + +-+-+ + +-+-+ +
|     | | | | |     |   |   | |   | | | | | | |   | |   | | |
+ + + + + + +-+ + +-+-+ + + +-+-+-+ +-+-+-+ +-+-+ +-+-+ + +-+
| | | | |   | | |     |   | |   |     |     | |     |       |
+ +-+ +-+ + + +-+-+-+-+-+ +-+ +-+ + + +-+-+ + +-+-+ + +-+-+-+
|   | |   |     | |     |       | | | |   |     |   |       |
+-+-+ + +-+ + +-+ +-+ +-+ +-+-+ + +-+-+-+ +-+-+ +-+ + +-+ + +
| |     |   |                 | |   | |       | |       | | |
+ +-+-+ +-+-+-+-+-+ +-+-+ + +-+ + + + +-+-+-+ +-+ + +-+ + +-+
| | |   |       |     |   |   |   |   |   |     | |   | |   |
+ + + +-+-+-+-+ +-+ +-+-+ + +-+ + +-+-+-+ + + +-+-+ + + +-+ +
|   |         | |     |   | | | |   | |   | |       | | | | |
+-+ + + + + + + +-+ +-+ +-+-+ +-+ +-+ +-+ +-+-+ +-+-+-+ + + +
|     | | | |   | |   |   | | |   |     | |     |   |   |   |
+-+ +-+ +-+-+ + + +-+ + +-+ + +-+-+-+ + + +-+-+-+ +-+ + +-+ +
| |   |     | | |     |         | |   | |   |     |   | | | |
+ +-+-+ +-+-+ + +-+ +-+ + + + +-+ + +-+ + +-+-+-+ + +-+-+ + +
|       |     |   | | | | | | |   |   |   | | |     | |     |
+-+ +-+ +-+-+ +-+-+-+ +-+ + + + + + +-+ + + + + + +-+ +-+ + +
|     |     | |   | |     | |   |   | | | |     | |   |   | |
+ +-+ +-+ + + + +-+ +-+ + +-+-+-+-+ + + +-+-+-+ +-+-+ +-+ + +
| | | | | | |       |   |   |   |   |     |   |       |   | |
+ + +-+ + +-+ +-+-+ +-+-+-+-+ +-+-+-+ +-+-+-+ +-+ +-+ +-+ +-+
|       |   | |                     |         |   |   |     |
+-+-+-+-+-+-+-+-+-+-+-+-+-+-+-+-+-+-+-+-+-+-+-+-+-+-+-+-+-+-+
