15
12
+-+-+-+-+-+-+-+-+-+-+-+-+-+-+-+
|   |         | |   |   |   | |
+-+ +-+-+ + +-+ + + + +-+ +-+ +
|   |   | |   | | |           |
+-+ + + + + +-+ + +-+ + +-+ + +
|     |   |       |   |   | | |
+-+-+-+-+-+-+-+ + +-+-+ +-+ + +
|       |     | | | | | | | | |
+-+ +-+ +-+-+ + +-+ + +-+ +-+-+
|   |   |   |     |   | |     |
+-+ +-+-+ +-+ +-+ +-+ + +-+-+ +
|     | | |   |   |   | | | | |
+-+ +-+ + + +-+ +-+ +-+ + + + +
| | | | |   |   | |   |     | |
+ + + + +-+-+-+ + +-+ +-+-+ + +
| | | |   | |             |   |
+ + + + +-+ + +-+ +-+ + +-+ + +
|       | | |   | | | |   | | |
+-+ +-+ + + +-+-+-+ +-+-+ + +-+
|   | | |       |   | | |     |
+-+ + +-+-+ +-+ + + + + + +-+-+
|       |   |     | |         |
+-+ +-+-+ +-+ + +-+-+-+ + +-+ +
|           | |         |   | |
+-+-+-+-+-+-+-+-+-+-+-+-+-+-+-+
