5
5
+-+-+-+-+-+
|     | | |
+ +-+-+ + +
|       | |
+-+ +-+-+ +
| |     | |
+ +-+ +-+ +
| | |     |
+ + +-+-+ +
|         |
+-+-+-+-+-+
