15
12
+-+-+-+-+-+-+-+-+-+-+-+-+-+-+-+
|   |     | |   |       |   | |
+ +-+-+-+ + +-+ + + + + +-+ + +
|     |           | | | |     |
+-+ +-+ +-+-+-+-+-+-+ +-+-+-+ +
|     |       |   |   |       |
+ +-+-+ + +-+-+ +-+ + +-+ + +-+
| | |   | |     | | |     | | |
+ + +-+ + + + +-+ +-+-+-+ + + +
|     | |   |     |   |   | | |
+ + + + + + + +-+ +-+ +-+-+ + +
| | |   | | | | | |           |
+ + +-+-+-+-+ + + + +-+ +-+ +-+
| | | |   |     | | |   |     |
+-+-+ + +-+ + +-+-+ +-+-+-+-+-+
|     | |   |     | | |   |   |
+ + +-+ +-+ + +-+ +-+ + +-+-+ +
| |         | | |     | | |   |
+-+-+ + + +-+-+ +-+-+ + + + +-+
|     | |       |             |
+-+-+ + + +-+ +-+ +-+-+-+-+-+ +
|   | | | |   |       |     | |
+ +-+ +-+-+ + +-+-+-+-+-+-+ +-+
|     |     |                 |
+-+-+-+-+-+-+-+-+-+-+-+-+-+-+-+
