10
10
+-+-+-+-+-+-+-+-+-+-+
| | |         |     |
+ + +-+-+ +-+-+-+ + +
|       | | |   | | |
+-+ +-+ + + + +-+ + +
|     |     | |   | |
+-+ +-+ +-+-+ +-+ +-+
| | | |   | |   | | |
+ + + + +-+ +-+ + + +
|   |     | |   |   |
+ +-+ +-+-+ + +-+ +-+
| | | | |   |       |
+ + + + + +-+-+ +-+-+
| |       |         |
+-+ +-+-+ + + +-+-+ +
|       |   | |   | |
+-+ + + +-+ + + + +-+
|   | | |   |   |   |
+ +-+-+-+ +-+ + +-+ +
|     |   |   |   | |
+-+-+-+-+-+-+-+-+-+-+
