50
50
+-+-+-+-+-+-+-+-+-+-+-+-+-+-+-+-+-+-+-+-+-+-+-+-+-+-+-+-+-+-+-+-+-+-+-+-+-+-+-+-+-+-+-+-+-+-+-+-+-+-+
|       |   |   |   |   |       |     | |   | |       |     | |     |     |   |   | |         |   | |
+ +-+-+-+-+ +-+ +-+ +-+ +-+-+ + + + + + + +-+ +-+ +-+ + +-+-+ + + + + + +-+ +-+-+ + +-+-+-+ +-+-+ + +
|             | |     |       | | | | | |   | | |   | |       | | | | |   |     |     |   | |       |
+-+-+ +-+ +-+ + +-+-+ + + +-+-+-+ + +-+ +-+ + + +-+-+ + +-+ +-+ +-+-+-+ +-+-+ +-+-+-+ +-+ + + +-+ +-+
|       | | | | |       |       | |     | |       |     |   |     |       |     | |   |     |   | | |
+ +-+-+ +-+ + + + + +-+-+-+-+ +-+ +-+ + + +-+-+ +-+-+ +-+ + + +-+-+-+ + +-+-+ +-+ +-+ +-+-+ +-+-+ + +
| |   |   |   | | | | |           |   | | | |         |   |     |   | | |       |         |   | |   |
+ +-+ + +-+ + + +-+-+ +-+-+-+-+ + +-+-+ + + +-+-+ + +-+ + +-+-+ + + +-+ + +-+ + + +-+-+-+ +-+ + + +-+
| | |     | |     |     |       | |   |   |       |   | | |   | | |   |   |   |       |   |         |
+-+ + +-+-+-+-+-+ +-+-+ +-+ +-+-+ + +-+ + +-+-+-+ +-+ +-+-+-+ + +-+ + +-+ +-+ +-+ + +-+-+-+-+ + + +-+
| |   |   |   |   | |   |   | | | | |   | |     |   | | |   | | |   | |     |   | |   |       | |   |
+ +-+-+ + + +-+-+ + + +-+-+ + + +-+ +-+-+-+ +-+-+-+-+ + +-+ + +-+ + +-+-+-+-+-+-+-+-+ +-+-+-+-+ + + +
|       | |   |   |   | | |     | |     |   |   | | |     |     | |     |               |   |   | | |
+ +-+-+ +-+ +-+ +-+ +-+ + + +-+-+ +-+-+ + + + +-+ + +-+-+ + + +-+ + +-+-+ +-+-+-+ +-+-+ + + + + + +-+
|     |   |   |         | | |           | | | |   |     |   | |   | | | |   |   | |     | |   | |   |
+ +-+ +-+ +-+ + +-+-+-+-+ + +-+-+-+ + + +-+ + +-+ + +-+-+ +-+-+ + +-+ + +-+ + +-+-+-+-+ + +-+ + +-+-+
| |     |         |     |           | |         |       |   |   | |   |             |   |   | |     |
+-+-+ +-+ +-+ +-+ +-+-+ +-+-+-+-+-+ +-+-+-+-+ +-+-+-+ +-+ +-+ +-+-+-+ + +-+ +-+-+-+-+ + + +-+-+-+ + +
| | |   |   |   | |             |         |   |   |         | |     |     |     |   | |     |     | |
+ + +-+ +-+-+-+-+ + + +-+ + +-+ + +-+-+-+ + +-+ +-+ + +-+ +-+ +-+ + + + + +-+-+ + +-+-+-+-+-+-+ + + +
| |     | | |   |   | | | |   | |     |   | | |   | | |   |   |   |   | |   |   | |   |   | | | | | |
+ +-+ +-+ + +-+ + + +-+ +-+-+-+-+-+-+-+-+ +-+ + + + +-+-+ +-+ +-+ +-+-+-+-+-+-+ + + +-+ +-+ + + + +-+
|   |           | | |     |   |   |   |   |   | | |   |   |     | |   | | |   |     |   |   |   | | |
+ + +-+ +-+-+-+-+-+-+ +-+ + +-+ + + +-+-+ + + + + + +-+ + +-+ + +-+ + + + +-+ +-+ +-+ +-+ + +-+-+ + +
| |     | | |       |   | |     |   |       | | |     | | | | |   | |         | |   | |   | |       |
+-+ +-+ + + + +-+ +-+ +-+ +-+-+ +-+-+-+-+ +-+ +-+ + +-+ + + + +-+-+-+-+-+-+-+ + + +-+ +-+ +-+-+-+-+ +
| |   | |   | |   |     |       |   | | | |     | | | | |     |   | |   |           | |     | | | | |
+ + +-+ + +-+-+ +-+ +-+-+-+-+ +-+ +-+ + + + + +-+ + + +-+-+ +-+ +-+ + + + +-+ +-+ +-+ +-+-+ + + + + +
| | | |   |         |       | |   |   |   | | |   |   | |       | |   |     | |         |     |     |
+ +-+ + + + + + +-+ +-+ + + + + + + + +-+ +-+ +-+-+ +-+ +-+-+-+-+ +-+ +-+ + +-+-+-+ +-+ + + +-+ +-+ +
|   |   | | | | |     | | | |   | | |     | |           |       |       | |   |     |   | | | | |   |
+ + +-+-+ +-+-+ + +-+-+-+ +-+ + +-+ + +-+-+ +-+ +-+-+-+-+-+ + +-+-+ +-+ + + +-+-+-+-+ +-+ +-+ +-+ + +
| |   |         | |   |       |   | |   | |     | |   |   | | |     |   | |   |                 | | |
+-+-+ +-+-+-+ + +-+ +-+ + + + + +-+-+-+-+ +-+-+ + + + +-+ +-+ +-+ +-+-+-+-+ + +-+-+-+ +-+-+ +-+-+-+-+
| |     |   | |   | |   | | | |   |     |   |       |   |         |       | |   |   | |             |
+ +-+-+ + +-+ +-+-+ + + + +-+-+-+ + + + + +-+ +-+-+ +-+ + +-+ + +-+ +-+-+-+-+ +-+ +-+-+-+ + +-+-+ +-+
|   |   |   | |       | |       |   | |           | |       | |             |   | | |     |     |   |
+ +-+ + + + + +-+-+-+ +-+-+-+-+ + +-+-+ + +-+-+-+-+ + +-+-+-+-+ +-+ + +-+ +-+-+ + + +-+ +-+ +-+ +-+-+
|     |   | | | |     |   | |   | |   | | |         | | |         | |   |   |   |   |   |   | |     |
+ +-+-+ +-+ + + + +-+-+ +-+ +-+-+ +-+ +-+ + + +-+ +-+-+ +-+ +-+ +-+-+ +-+-+-+-+ + +-+-+-+ +-+ + + + +
| |     |     | |     |   |     | |   | | | |   | |     |   |   |       |     |         | |     | | |
+ + +-+ + + +-+ +-+ + + + + +-+-+ + + + +-+-+ +-+-+ +-+-+-+ +-+ + +-+-+ + + +-+-+-+ + +-+-+ + + +-+-+
| |   | | | |     | |   |   |   | | | | |               | | |   |     | | | |   | | | |   | | | | | |
+ +-+ + + +-+ + +-+-+-+-+-+ +-+ + +-+ + +-+-+-+-+ + +-+-+ + + +-+-+-+-+-+ +-+-+ + + +-+ + +-+ + + + +
| | | | |   | |     |     |     |   |       |     | |   |   | |   |     |     |     | | | |   |   | |
+-+ +-+-+ + + + +-+-+-+-+ +-+-+ +-+ +-+ +-+ +-+-+ +-+-+ + +-+ +-+ +-+ +-+ +-+-+-+ + + + +-+ +-+-+-+ +
|   |   | |   | | |   | |         | | |   |   |   | | |   |       |   | |   |   | | |     |         |
+ +-+ +-+ +-+-+-+ +-+ + +-+-+ + +-+-+ +-+ +-+-+-+ + + + +-+ +-+-+ +-+ + + +-+-+ + +-+-+ +-+ +-+-+-+ +
|     |         | |       | | | |     |       |     | |   |   |           | |   |         |   | |   |
+-+ + +-+-+ +-+ + +-+ +-+-+ +-+-+ +-+-+-+-+ + +-+-+-+ +-+ +-+-+-+ +-+ +-+-+ + +-+ + + +-+-+ +-+ +-+ +
| | |       | |   |       |     |   |     | |   |       |   |     | |       |   | | |     | | |   | |
+ +-+-+ +-+-+ + +-+ +-+-+-+-+ +-+ +-+ +-+-+ +-+ +-+-+-+ +-+ +-+-+ + + +-+-+ + +-+ +-+-+-+-+ + +-+ + +
| |   | |         | |         |       |   |   | | |     |     |     |   |   |   |       | | |   |   |
+ +-+ + + +-+ +-+ + +-+-+ + +-+-+-+ + +-+ +-+ +-+ +-+ +-+ +-+-+ +-+ +-+ +-+-+ +-+-+ + + + +-+ + +-+ +
|       |   | |           | |     | | |   |   | | |   | |     | | | |   |   |       | | |     | | | |
+ + +-+-+-+-+ + + +-+-+ + +-+ + +-+ +-+ +-+ +-+ + +-+ + + + +-+ + +-+-+-+ +-+ + +-+-+ +-+-+-+ +-+ +-+
| |     | | | | |     | | |   |   | |   | |           |   | |   | | |         | |   |     |       | |
+-+-+-+-+ + +-+ + + +-+-+-+-+ +-+-+ + + + + +-+ + +-+-+-+ +-+-+-+ + + +-+-+ + +-+-+ + +-+-+ + + +-+ +
|     |     | | | | |       | |   | | |     |   | | |   | | |       |   |   | |     |     | | |     |
+ +-+ +-+-+ + + + +-+-+-+ + + +-+ + + +-+-+-+ +-+ + +-+ + + +-+ + + +-+ + +-+-+ +-+-+ +-+-+-+ +-+-+ +
| |     | |     |       | |     |       |     |     | |   | |   | |   | |       |         |     |   |
+-+-+ + + +-+ +-+-+-+ + + +-+-+ + +-+-+-+-+-+-+-+ +-+ + + + + +-+-+-+ + +-+-+ +-+-+-+-+-+ + +-+-+-+-+
|     | |       | | | | |     | | | |     |   | |   |   |   | | | |     |   |     | |   |       |   |
+-+ +-+ + +-+-+-+ + +-+ +-+ +-+ + + + +-+-+ +-+ + +-+-+-+-+ +-+ + + + +-+-+ +-+ +-+ + + + +-+-+-+ + +
| |   | |       |   | |   | |         |     |   | |       | | |     |   | | |     |   | | |     | | |
+ + +-+-+ + +-+-+ +-+ +-+-+-+-+-+ + + + +-+ + + + +-+-+-+ + + +-+ + +-+-+ + + + + +-+-+ + +-+-+ + +-+
|       | |   |           | |     | |     | | | |   | |     |   | |         | | |   |   | | | |     |
+ + +-+ + + +-+ + +-+ + +-+ +-+ + +-+-+ +-+ + + +-+ + + +-+-+-+ + +-+ +-+-+-+ +-+ +-+ +-+ + + + +-+ +
| | |     | |   |   | |   | |   |   | |   |   | |   |   |     |   | |   |   | |   |   | |     | |   |
+-+ + +-+-+ +-+ +-+ +-+-+-+ + +-+-+ + + +-+ +-+-+ + + +-+ + + +-+-+ +-+ + +-+ +-+-+-+ + +-+-+-+-+-+ +
| | |   | |       | |       | | |     |   | | |   |     | | | |   |   | |     |   |     |     |     |
+ +-+-+-+ +-+-+-+-+ + +-+-+ + + +-+-+ + + +-+ +-+ +-+-+ + + + +-+ +-+ + + +-+-+-+ + + +-+ +-+ +-+ +-+
|   | |     |     | | |             | | |     |   |   | | | | |     |   |       | | | |   |         |
+-+ + + + + + +-+-+ + + +-+-+ +-+-+-+ + +-+ +-+-+ + +-+ + +-+-+-+-+ +-+ + +-+-+ + + + + + +-+-+ +-+ +
| |   | | | | |   | | |   |     | | | | |   | |       |           |   | | |   |   | |   | |       | |
+ +-+ +-+ + + + +-+-+-+-+-+-+ + + + +-+-+ +-+ + +-+-+ + + + + +-+ +-+ + + + +-+-+-+-+ + + +-+ +-+-+ +
|     |   |     |         |   |     | |   |   | | | | | | | |   | |   | |           | | | | | | |   |
+ +-+ +-+-+ +-+ +-+-+ +-+-+ +-+ +-+-+ +-+ +-+ + + + + +-+ +-+-+-+ + + + +-+ +-+ + +-+-+ +-+ + + +-+ +
| | |   |   | |   | |   | | |           | |   |     | | | |     | | |   | | |   |     | |         | |
+ + +-+ + + + +-+-+ + + + + +-+-+-+-+ + +-+-+ +-+ +-+-+ +-+-+ + +-+-+-+-+ +-+ + +-+ +-+-+ +-+-+-+-+-+
|   |     |   |   | | |   |         | |   | |     |   |     | | | | |       | |   | | | |   |   |   |
+-+ +-+-+ +-+-+ +-+ +-+ +-+ +-+-+-+-+ +-+-+ + + +-+ + +-+ + + +-+ + +-+-+ +-+ +-+ +-+ + + + +-+ +-+ +
| | |   |   | | |   |     | | |   | | |   |   | | | |   | |     |     |   | | |     |     | |   |   |
+ + + +-+-+ + + +-+ + +-+ + + +-+ + +-+-+ +-+ +-+ + +-+-+-+ +-+ +-+ +-+ +-+ +-+ + + + + +-+ +-+ + +-+
|   |   |   | |       | | |   |     |   | |       | |   | | | | |     |     |   | | | | | |     |   |
+ +-+-+ + + + +-+ +-+ + + +-+ +-+ +-+ +-+ + + +-+ + +-+ + + + + + +-+-+ +-+-+-+ + + + + + + +-+ + +-+
| |       |     | | | |   |   | | |     |   |   |   |     | |     | |     |     | |   |   | |     | |
+ +-+ +-+ +-+-+ + + + + + +-+-+ + + +-+-+-+ + + + +-+ +-+ + +-+ + + + + +-+ +-+ + +-+-+-+-+-+-+-+ + +
| |     |   |   | |   | |         | |     | | | |   |   |   |   | |   | | | | | | |     | |     | | |
+-+-+ +-+ + +-+ + +-+-+ +-+-+ +-+-+ + +-+-+ +-+ +-+-+-+ +-+-+ +-+-+ +-+-+ + + +-+ + +-+-+ +-+-+ + + +
|   | |   | | |   | | | |         |     |   |       | | |       |   | |   | |         | |   | |     |
+ + +-+-+ +-+ +-+-+ + + +-+-+-+ + + + +-+-+ + +-+ +-+ +-+-+-+ +-+-+ + +-+ + +-+-+ +-+ + + +-+ +-+ + +
| | |   |     | |       |   | | | | |     | |   | |               | | |       | |   | |     |   | | |
+ + +-+ + + + + +-+ +-+-+ +-+ + + +-+-+ +-+ +-+-+-+-+-+ +-+-+ +-+-+ + + + +-+-+ +-+ + + +-+ +-+ + +-+
| |     | | | |   |   |         |   |   |   |       |   |       |   |   |   |     | | | |   | |     |
+ + + +-+ +-+ + + +-+-+ +-+ +-+-+-+ + + + + +-+-+-+ + +-+ +-+ +-+-+ +-+-+ +-+ +-+ + +-+-+ +-+ +-+ + +
| | |     |     | |     |   | |     | |   |       |     | |   |   |           | | |         |     | |
+ +-+ +-+-+-+-+ +-+ +-+-+ +-+ +-+ + + +-+-+ +-+ + +-+ + +-+ +-+ +-+-+ +-+ + +-+ +-+-+-+-+ +-+-+ +-+ +
|   | |           | |         |   |     |     | |   | | |             |   |         |     |       | |
+-+-+-+-+-+-+-+-+-+-+-+-+-+-+-+-+-+-+-+-+-+-+-+-+-+-+-+-+-+-+-+-+-+-+-+-+-+-+-+-+-+-+-+-+-+-+-+-+-+-+
