40
40
+-+-+-+-+-+-+-+-+-+-+-+-+-+-+-+-+-+-+-+-+-+-+-+-+-+-+-+-+-+-+-+-+-+-+-+-+-+-+-+-+
|     |       | | |           |   | | | |       |         | |   | |         |   |
+-+-+ + + +-+-+ + + +-+-+-+ +-+ +-+ + + + +-+ + + + +-+-+ + + +-+ +-+-+ +-+ + +-+
|       |     |     | | |     |           |   | | |   |   |         | |   |     |
+ +-+-+-+ +-+-+ +-+ + + +-+ +-+ +-+ +-+-+-+-+ + + +-+ +-+ + + +-+ +-+ + +-+-+ +-+
|     | |     | | |   | |     | |   |     |   |   | |   |   | |       |     |   |
+ +-+-+ +-+-+ +-+ +-+ + + + +-+ +-+ +-+ +-+ +-+-+ + +-+-+-+-+ +-+-+-+ +-+ +-+-+-+
| | |         |   | |   | |   | | | | |   |   | |     | |       |   |   |   |   |
+-+ + +-+-+-+ + +-+ + + +-+-+ +-+ +-+ + +-+ + + +-+ + + +-+ +-+-+ + + + + + +-+ +
|     |   | |     | | |     | |   |   |   | | |   | | |   | |     |   |   |   | |
+ +-+ + + + +-+ +-+ +-+-+ +-+-+-+ +-+ + + +-+-+ + +-+ + + + +-+-+-+-+-+ +-+ + + +
| | |   | |       |     | |   | |   |   | |   | | |   | |   |       | | |   |   |
+-+ +-+-+-+-+-+-+ + + +-+ +-+ + +-+ +-+ + + + + +-+-+-+-+ +-+-+ +-+-+ +-+-+ + +-+
|   | |       | | | | | | | | |     |   | | |     | |         | | |   |   | |   |
+ + + +-+ +-+-+ + +-+ + + + + + +-+ +-+ +-+ +-+ +-+ +-+ +-+-+ + + + + + +-+-+-+-+
| |     |                   |     |   | | | |         |   | | | | | | |         |
+ +-+-+-+-+-+-+-+-+ +-+-+ +-+-+ +-+-+-+ + + +-+-+-+-+-+ + + + + + + + +-+ +-+-+-+
| | |     |         | | |       | | |     |       |     |   | |     | |   |     |
+ + +-+ +-+-+ +-+-+ + + + +-+-+ + + +-+ + +-+ + + +-+-+ +-+-+ +-+ +-+ + +-+ +-+ +
|         |   |         | |     | | |   |   | | |   |     |   |   |         | | |
+ +-+-+-+ +-+ +-+-+-+ +-+-+-+-+-+ + +-+ + + + +-+-+-+-+ + + +-+-+-+-+ +-+-+-+ +-+
| |   |   | |   |       |         |   | | |       |     | | | | | | | |       | |
+-+ + +-+ + +-+ +-+ + +-+-+-+-+-+ + +-+-+-+ + +-+-+ + + +-+-+ + + + + + +-+-+-+ +
|   |           | | |   |   |       |   | | | | |   | |   | |       |   | |     |
+ + +-+-+-+ + +-+ +-+ +-+-+ + +-+-+ +-+ + + + + +-+-+-+ + + + +-+-+-+ +-+ + +-+ +
| |     | | |     |       |     |       | | |     |     | |     |   | |       | |
+-+ +-+-+ +-+ + +-+-+-+-+-+-+ +-+-+-+ +-+ +-+ +-+-+-+-+ +-+ +-+ +-+ + + +-+-+-+ +
|   | | |     | |   | |   | |     |       |     |       | |   |   | | | | | |   |
+ + + + +-+-+-+ + + + + + + +-+-+ +-+ + + + +-+ +-+ +-+ + +-+ + + + + + + + + +-+
| | |       | |   |   | |   | |   | | | |     |     | | |     | |     | |   | | |
+-+-+-+-+ + + + +-+ +-+ + +-+ + +-+ +-+ + + +-+ +-+ + +-+ + + + +-+ +-+ + +-+ + +
|         |   |   |   | | |         |   | | | |   |     | | | | |   | |   | |   |
+-+ +-+-+ + + + +-+ +-+-+ +-+-+-+ + + +-+ +-+ + +-+-+-+ + + +-+-+-+-+ + +-+ + + +
| | | |   | | |   | |     |     | | | |   |   | |     | | |   |         | |   | |
+ +-+ + + +-+ + +-+-+-+-+ + +-+-+ +-+-+ +-+-+ + +-+ +-+ + + +-+ +-+ +-+-+ + +-+-+
|   |   |   |       |       |       | |     | |       |   |   | |   |   | | |   |
+-+ +-+ +-+ +-+ +-+-+-+-+-+ +-+-+-+-+ + +-+ + + +-+-+ + +-+ + +-+ + +-+ + + + +-+
|   |   | | |   |   | |                 |     |   | | | |   |     |     | |     |
+ +-+ +-+ +-+-+ + + + +-+ +-+ +-+ +-+ +-+ +-+-+-+-+ + + + +-+ +-+-+-+-+ + +-+ + +
|   | |   | | |   |   |   | |   |   | | | |       | | | |   |     | |   | | | | |
+ +-+ +-+ + + +-+-+ +-+ +-+ +-+-+ + +-+ +-+ +-+ +-+ + +-+-+-+ + +-+ +-+-+ + +-+-+
|   |   |   |   |     | |       | |       |   |     |   |   | | |     |         |
+-+ +-+-+-+ +-+ + + + + +-+ +-+-+ +-+-+-+-+-+ +-+ +-+-+-+ + + +-+ +-+ + + +-+ +-+
|       | |     | | |   | | | |     | |         |     |   | |   | | |   |   |   |
+-+-+ +-+ + + + +-+ +-+ + + + + + +-+ +-+ +-+ + +-+ +-+-+-+ +-+ +-+ +-+-+-+-+ +-+
| |         | |   | | | |   |   | |     |   | |   |   |         |     | | |     |
+ + +-+ +-+ +-+-+ +-+ +-+ +-+ +-+ +-+ + +-+ +-+-+-+-+ +-+ + +-+-+-+-+ + + +-+ + +
|   | |   | |   | |     |     | |     | |         |   |   |             |   | | |
+-+-+ +-+-+-+-+ + +-+-+ +-+ +-+ + +-+ +-+ + +-+-+ + +-+ +-+-+-+-+ + +-+ + +-+ + +
|   | |   |   |     |         | | |   | | |   | | | | | |     |   |   |     | | |
+-+ + +-+ +-+ + +-+ +-+-+-+ +-+ +-+-+ + +-+ +-+ +-+-+ + +-+ +-+-+-+ + +-+ +-+ +-+
|   |   |     |   |   |         |                 |         |     | | |         |
+ + +-+ + +-+ +-+-+-+ + +-+ +-+-+-+-+ +-+-+-+-+ + +-+-+ +-+ +-+ + +-+ +-+-+-+ + +
| |   |     | |       | | | | |     |   |       |     | |   |   |   | |       | |
+-+ +-+-+ +-+-+ + + + +-+ + + +-+ +-+ +-+-+ + +-+-+ + + +-+-+-+ +-+-+-+-+ +-+-+ +
|         |     | | | |   |     | | | |     |     | | |     | |   |         | | |
+-+ +-+-+ +-+ +-+ +-+-+-+ +-+-+ + + +-+-+ +-+ + +-+-+ + +-+ + +-+ +-+ +-+-+-+ +-+
|   | |     | | |   |   |   |     | |       | | |     |   | | |   |     |   |   |
+-+ + +-+ +-+ + +-+-+ + + +-+-+ +-+ + +-+-+ +-+-+-+-+-+-+ + + +-+ + +-+-+ + +-+ +
| |     | |           |   |   | | |       |     | |     | | |   |         |     |
+ +-+-+-+ + +-+ + + +-+-+ + +-+-+ + +-+ + +-+-+-+ +-+ + +-+ + +-+-+-+ +-+ + +-+ +
|   |         | | |   |     |     | |   | |   |   | | |         |     |   | |   |
+ +-+ +-+ + + +-+-+ + + + +-+-+-+ + + +-+ + + + + + +-+-+-+ +-+-+ + + +-+ +-+-+-+
|   |   | | | |     | | |   | | | | | |   | |   | | | |   |   |   | | |     |   |
+ + + +-+-+-+-+-+-+ + +-+ + + + + + + +-+-+-+ + +-+ + + +-+-+-+-+-+-+ +-+-+-+ +-+
| | | | |     |   | | | | |   |     | |     | | |           |       |       |   |
+-+ +-+ +-+ +-+-+ +-+-+ + + +-+-+-+ +-+-+ +-+-+ +-+ + + + +-+ +-+ + + + +-+-+ +-+
|             |   |       |   |   | | | |   |   |   | | | |     | |   | |       |
+ +-+ + + + + + +-+ +-+-+ +-+ + + + + + + + +-+ + + +-+ +-+-+-+ + +-+ +-+-+-+ +-+
| | | | | | | |   | | |   | | | |         |     | |   |   | |   | |   |   |   | |
+ + + + + +-+-+-+ + + +-+-+ + + +-+-+ + +-+-+ + + +-+ + + + + +-+ +-+ + +-+ +-+ +
|   | | |         |   |             | | | |   | | |   | |   | |     |           |
+ +-+ +-+ + +-+-+-+-+-+ + + +-+-+ +-+ + + + +-+-+-+-+-+-+-+ +-+ + +-+-+ +-+-+-+ +
| |     | | |         | | | |   | | | | |       | |       | |   |   |     |   | |
+-+ +-+-+ +-+ + +-+ +-+ + +-+ + +-+ +-+-+ +-+-+ + +-+-+ +-+ + + + + +-+ +-+ + + +
|     |   |   | |       | | | | |     | |   | | |   |       | | | | |     | | | |
+ +-+-+-+-+ +-+-+ +-+-+-+-+ + +-+-+ + + + +-+ +-+-+ + +-+ + + + +-+-+-+ +-+-+ + +
|   |       |   |                   | | |   |     |   | | |   |     |       |   |
+ + +-+ + +-+ +-+-+ +-+ +-+ +-+-+ +-+ + +-+-+ + +-+-+ + +-+-+-+ + + + + + +-+ +-+
| |     |   |       |   |       |   |         | |       |       | | | | | |     |
+-+-+-+-+-+-+-+-+-+-+-+-+-+-+-+-+-+-+-+-+-+-+-+-+-+-+-+-+-+-+-+-+-+-+-+-+-+-+-+-+
