50
50
+-+-+-+-+-+-+-+-+-+-+-+-+-+-+-+-+-+-+-+-+-+-+-+-+-+-+-+-+-+-+-+-+-+-+-+-+-+-+-+-+-+-+-+-+-+-+-+-+-+-+
|   |   |   |   |     | |     |       |     |   |   | | |     |     |         | |   |   |         | |
+ +-+ +-+ +-+-+ + +-+ + +-+-+ + +-+ + +-+-+ +-+ + + + + +-+ +-+ +-+-+-+ +-+-+-+ + + +-+ + +-+-+-+ + +
|       |       | |         | |   | |       |   | |     |               |   |   | |     |   |     | |
+ + +-+-+-+-+ +-+ +-+ + + + + +-+-+-+-+ + + +-+ + + +-+-+-+ +-+ +-+ +-+-+-+ +-+ + +-+ +-+ + +-+-+-+ +
| |     |   | |   |   | | | |           | |   | | | | | |     | |     |           |   |   | |   |   |
+ + + + + + + + + +-+ +-+ + +-+ +-+-+ + +-+ +-+ + + + + +-+ + +-+ + +-+ +-+ +-+-+-+-+-+ + + +-+ + +-+
| | | | | |   | |   |   | | |       | |   | |     | |       |   | |     |   |   | | | | | | | |     |
+ + +-+-+-+-+ +-+-+-+-+ +-+ +-+-+ +-+-+-+-+-+-+-+-+ + +-+-+ +-+-+-+-+ +-+-+ +-+ + + + +-+ +-+ +-+ + +
| |     |   |           | | |   | | |     |         |     | |   |   | | |     | | |             | | |
+-+ +-+-+-+ +-+-+-+ + +-+ +-+-+ + + + + + + +-+-+-+ +-+ + +-+ + + + + + + + +-+ + + + +-+ +-+ +-+ + +
| | | |     |     | |         |     | | | |     | |     | | | | | | | |   |         | |   |   | | | |
+ + + + +-+-+-+-+ +-+ +-+ +-+ +-+-+ + + +-+ +-+-+ +-+-+ + + +-+ + +-+ +-+ +-+ + +-+ + + +-+-+-+ + +-+
| |       |     |       |   |         |   |   | |       |         |   | | | | | |   | |   | |       |
+ + +-+-+-+-+-+ +-+ +-+-+-+ +-+-+-+-+-+-+-+ + + +-+ + +-+ +-+ +-+-+-+ + + + +-+-+-+-+ +-+ + +-+ + +-+
|     |   |   |   | | |             |   |   | | |   | | |   | |     | |   |   |   | | | |       |   |
+-+ + + + +-+ +-+ + + +-+-+-+-+-+ +-+ +-+-+ + + +-+-+ + +-+-+-+-+ + +-+ + + + +-+ + +-+ + +-+-+-+-+ +
|   | | | |             |   |       |       |     | | |     | |   |     | | |   |     | |   |     | |
+-+-+ +-+ +-+ +-+ +-+ +-+ +-+-+ +-+ + + + + +-+ + + +-+-+ + + + + +-+-+-+-+ + +-+ +-+-+ + +-+ + +-+ +
| | | |     | | |   | | |   | | | | | | | | |   | | |     | | | |           |     |   |     | |   | |
+ + + +-+ + +-+ + +-+ + + +-+ + + + + +-+ +-+ + +-+ + +-+ +-+ + +-+-+-+ +-+-+ +-+-+ + +-+-+ +-+-+ +-+
|         | | |   |       |       | |   | | | | |   |   | |       |   |   |       | |   |     |     |
+-+-+-+ + +-+ +-+-+-+-+ +-+ +-+-+ +-+ +-+-+ +-+ +-+ + + + + +-+-+ + + + +-+-+ +-+-+ +-+-+ +-+ + + +-+
|       |   |       |     | |         |       |   | | | |       | | |   |   |     | | |     |   |   |
+-+-+-+-+ + + +-+ +-+ + + +-+-+-+ +-+ +-+-+ +-+-+ + +-+ +-+-+-+-+-+-+-+-+-+ + +-+-+ + +-+ +-+ +-+ + +
| |       | | | |   | | | |     |   | | | |   |       |   | |     | |           | |   | |   |   | | |
+ +-+ +-+-+-+ + +-+-+-+ +-+ + +-+ +-+ + + + +-+ +-+ + +-+-+ +-+-+ + + +-+ +-+-+ + +-+ + +-+-+ +-+-+ +
|     |   | |         |   | |     | | |     |     | | |     |       |   |     | |     | |       |   |
+-+ + + + + +-+ +-+-+ + +-+-+-+-+ + +-+ + + +-+-+ +-+ + +-+-+ +-+-+-+-+ + +-+ +-+ +-+-+ +-+ +-+ + + +
| | |   | | |     | |           | |   | | |       |                 |   |   |     |   | |   | | | | |
+ +-+ +-+-+ +-+ +-+ + +-+ +-+ + +-+ +-+ +-+-+-+ +-+ +-+ +-+-+-+ + +-+ +-+-+-+-+-+-+ +-+ +-+ + +-+-+ +
|   | |         | |     | | | | |         |   |   | |     | |   | |                       |   |   | |
+-+ + +-+ +-+-+ + +-+ +-+ + +-+-+-+ +-+-+ +-+ + + +-+-+ + + +-+-+-+-+-+ +-+ + +-+-+-+-+ +-+-+ +-+ +-+
|   |       |     |     | | | | | | |         | |   |   |   | |     |   | | |   |   |   | |         |
+ +-+ +-+-+ +-+ +-+ +-+ +-+ + + + +-+ +-+ +-+-+-+-+-+-+-+-+ + + +-+ +-+-+ +-+ +-+ + +-+-+ +-+ +-+ +-+
| | |   |   |   |   |   |   |       | |         |   | |       |   | |       |   | |   |   |   |     |
+ + + + + + +-+-+-+ + + + + +-+ +-+-+-+-+ +-+ +-+ + + +-+-+ + + + +-+-+-+ +-+ + + +-+-+ +-+-+ +-+ + +
|   | | | |   |   | | | | |   |   |     | |       | |     | |   |       |   | |     | | |   | | | | |
+-+ +-+-+ +-+-+ +-+ + +-+-+-+ + + + +-+-+-+ +-+-+-+ + +-+-+-+ +-+-+-+ +-+ +-+ +-+-+ + + +-+ +-+ +-+-+
| |         |   | | | |         | |   |   | |     |     |   | |             |   |   | |     |   |   |
+ +-+-+-+ + + +-+ +-+-+-+ +-+-+-+ + +-+ +-+-+ + +-+-+ +-+ + + +-+ +-+-+ +-+-+-+-+-+-+ + +-+-+-+ +-+ +
|     | | | |       |         |     |   |   | |   |       | |   | | |   | | |           |       |   |
+-+-+ + +-+ +-+ +-+-+-+ + + +-+ + +-+ +-+ +-+ + +-+ +-+-+-+-+-+-+-+ +-+-+ + + +-+-+ +-+ + +-+ + + +-+
|   |                 | | | |   |       | |   |   |     |     |   | |   |   | | | | |     | | | |   |
+-+ +-+ +-+-+-+ +-+ +-+ +-+-+-+ +-+-+ + + + +-+-+ + +-+ +-+ + +-+ + + + +-+ + + + +-+-+-+ + +-+-+ + +
|       |     |   | | | |     | | |   |     |       |   | | | |       | | |     |   | |   | | |   | |
+ +-+ + +-+-+ + + +-+ +-+ + +-+-+ +-+ +-+ + + + +-+ +-+-+ +-+ + + +-+-+ + +-+-+ + +-+ + +-+ + + +-+-+
| |   | |     | | |       |   | | |     | | | |   |         |   |   | |       | |       |   |       |
+-+ +-+ +-+ +-+ +-+ + + + +-+ + + +-+ + +-+-+ + +-+ + + +-+ +-+ +-+ + +-+ +-+-+-+-+-+-+ +-+ + +-+-+ +
| |   |       | |   | | |   | |       | | |   |   | | | | | |     | |             |   |   | | |   | |
+ +-+-+ +-+ +-+ +-+-+ + +-+-+ + + + +-+ + +-+-+ +-+-+-+-+ +-+ +-+-+-+-+ +-+ +-+ + + +-+ +-+ +-+ + + +
| |       |   |   |   | | | | | | |   |     |   |   |     | | |       | |     | |   |           |   |
+ +-+-+ + +-+-+ +-+ +-+-+ + + +-+-+ + +-+-+-+ +-+ + + +-+ + + +-+ +-+-+-+-+-+ +-+ +-+-+-+-+-+-+ +-+-+
| |   | |     | |     | |   | |   | | |     |   | |   |                 |       | | | | |     | |   |
+ +-+ + +-+ +-+-+-+ + + +-+ + + + + +-+ +-+ + +-+-+-+ +-+-+ +-+ + +-+-+-+-+-+ +-+ + + + +-+ +-+ +-+ +
| | | |   |       | | |         |         | | |       |       | |   | |         | | |   |       |   |
+ + + + +-+-+ +-+-+-+ +-+-+ +-+-+ + +-+-+-+-+ + +-+-+-+-+-+ + +-+ +-+ +-+-+-+ +-+ + +-+ +-+ +-+ +-+ +
|         | | |   |   | | |   |   | | |   |     |       |   |   |     |     | | | |     |   |   |   |
+ + +-+-+-+ +-+ +-+-+-+ + +-+ +-+-+-+ + +-+ + + +-+ +-+ +-+ +-+-+-+ +-+-+ +-+ + + +-+-+ +-+ +-+-+-+ +
| |   | |   |   | |   |     | |       | |   | | |   | |   | |         |     | |           |   |     |
+-+ +-+ +-+ + +-+ + +-+-+ + +-+ + + +-+ + +-+-+-+-+ + + +-+ +-+ +-+-+ + +-+ + +-+ +-+-+-+ + +-+ +-+-+
|   |       |       | |   |   | | |           |   | | |     |   | | |     | |   |       |           |
+-+-+-+-+-+ + +-+ + + +-+ +-+ +-+-+ +-+-+ + +-+-+ + + + +-+-+-+ + + + + +-+-+-+-+-+-+ + + +-+ +-+-+-+
|       |       | |   |   |   |   |     | |   | |     |   |   | | |   | |             | |   |   |   |
+-+ +-+ + +-+ + +-+ +-+ + +-+-+-+ + +-+-+ +-+ + + +-+ +-+ +-+ +-+ + + +-+-+-+ + +-+ +-+ + +-+ + +-+ +
|   |       | | |       | |       |   | |   | |   |     | |     | | | |   |   |   | |   | |   | | | |
+-+-+-+-+ +-+-+ + +-+-+-+-+-+-+-+ +-+ + + +-+-+ +-+-+ + +-+ + +-+ + +-+-+ + +-+ + + +-+ + + +-+-+ + +
|   |     |   | |           |   |     | | | |   |     | |   | |     | | |   |   | | | | | | | |     |
+-+ +-+-+ + + + +-+ +-+ + +-+ +-+-+-+ + + + + + +-+-+-+-+-+ +-+-+-+-+ + +-+ +-+ +-+-+ +-+ +-+ +-+ +-+
| |   | |   | | |   | | |   | |   |   |   |   |   |   | |   |       |       | |   | |         | |   |
+ +-+ + +-+-+ +-+-+ + +-+ +-+ + +-+ +-+-+-+ +-+-+-+ +-+ + +-+-+-+-+ + + +-+-+ + +-+ + +-+-+-+-+ +-+ +
|   |     |     |       | | | |     |     | |       | | |       | | | | |   |     |   |         |   |
+-+ +-+-+ + +-+-+ + +-+ + + + +-+ +-+-+ +-+ +-+-+-+ + + + +-+-+-+ + +-+ + + + + +-+-+ + + + +-+ + +-+
|       |   | |   |   | | |         |     |       | | |     |   | | |     | | |     | | | |   | |   |
+ +-+ + + +-+ +-+-+-+-+-+-+-+-+-+ + + +-+ + +-+-+ + + +-+ +-+-+ + + +-+-+ + +-+ + +-+-+-+ +-+ +-+ +-+
| |   | | |     |       | |     | | |   |   |   | |   |   | |         | | | | | | |     |   |       |
+-+ + +-+ +-+ + +-+ +-+-+ + + +-+-+-+-+ + +-+-+ +-+ +-+-+ + +-+-+ +-+ + +-+-+ + +-+ +-+-+-+ +-+ +-+ +
|   |   |     |       | |   | |       | |             | |           |   |   | | |   |         |   | |
+ +-+ + + +-+-+-+-+ +-+ +-+-+ + +-+-+-+-+ + + +-+ + +-+ +-+-+-+-+ + + +-+ +-+ +-+ + + +-+-+ +-+-+-+ +
|   | |   |     | | |     | |     |   |   | | |   | | | |         | | | |       | |       | |       |
+ + + +-+ + +-+-+ + +-+ +-+ +-+-+ + + + +-+ +-+-+-+ + + + + + +-+-+-+ + +-+-+-+ + +-+ + +-+ + +-+-+ +
| | | |     |     |       |         | | | | | | | |       | |   | |   |       | | |   | | | | |     |
+-+-+-+-+ +-+ +-+ +-+ +-+-+ +-+-+ +-+-+-+ +-+ + + + +-+-+-+-+-+-+ +-+ +-+ + +-+ +-+ + +-+ +-+-+-+ + +
|     |     | | |         |   |       | |     |   |   |       |     |     |   | | | |         |   | |
+-+ +-+ +-+-+-+ +-+-+-+-+-+ +-+-+ +-+ + + +-+-+ +-+ +-+ +-+-+-+-+ +-+ + +-+-+-+ + + +-+-+-+-+-+-+-+ +
|       |     |       | | |   | | |     | |       |     |     | | | | | |     |   | |   |         | |
+ +-+ +-+ +-+-+-+ +-+ + + +-+-+ + + + +-+ + +-+-+ +-+-+ + +-+-+ + + +-+-+ +-+ + + + + +-+-+ + + +-+-+
| |           |     |   |   |     | |     |     | |     |   | |     | | | |     |   | | |   | |   | |
+-+-+-+ +-+ +-+-+-+ +-+-+ +-+-+-+ +-+ +-+ +-+ +-+-+ +-+ +-+ + + +-+-+ + + +-+-+ + +-+ + +-+ + + +-+ +
|         |         | |     | |   | |   | |     |   | |         |           | | |   |   |   | |   | |
+-+-+-+-+ +-+-+ + + + + +-+-+ + + + +-+ +-+-+ +-+ +-+ + +-+ +-+-+ +-+-+ +-+ + + + + +-+ + + +-+ + + +
|           | | | | |         | |   |           |   |   |   | | |     | |     | | |       |   | |   |
+ + +-+ + +-+ +-+-+-+-+-+-+ + + + +-+ +-+-+ + +-+ +-+-+-+-+ + + + +-+ +-+-+ +-+-+ +-+-+ +-+ + +-+ + +
| | |   |       |     |   | | | |   | | | | | |     |       |       | |   | | |       | |   |   | | |
+-+ +-+-+ + +-+-+-+-+ + + + + +-+ +-+-+ + +-+-+ +-+ +-+-+ + + +-+ +-+-+-+ + + +-+-+-+ +-+-+-+-+ +-+-+
|   |     |             |   | |     | | | |   |   | |     |   |   |   | |       |   |   | | | | |   |
+-+ +-+ +-+ +-+-+ +-+-+-+ + +-+-+-+ + + + +-+ + + +-+ +-+ +-+-+ +-+ +-+ +-+ +-+-+-+ + +-+ + + + + +-+
| |   | |     | |       | |   |     |           | | |   | |         | |     |     | |         |     |
+ + +-+ +-+ +-+ + +-+ +-+-+-+ + + +-+ +-+-+-+ +-+ + + +-+ + + + +-+ + +-+ + +-+ + + + +-+ +-+ + +-+ +
|     | |   |       |   |       |     |         | |   |   | | | |   |     | |   |       |   | |   | |
+-+-+-+-+-+-+-+-+-+-+-+-+-+-+-+-+-+-+-+-+-+-+-+-+-+-+-+-+-+-+-+-+-+-+-+-+-+-+-+-+-+-+-+-+-+-+-+-+-+-+
