20
20
+-+-+-+-+-+-+-+-+-+-+-+-+-+-+-+-+-+-+-+-+
|       | |     |     |   |           | |
+ + +-+ + +-+ +-+ +-+-+ + +-+ + +-+-+ + +
| | |     | |     | |   |     |   |   | |
+-+-+ +-+-+ + +-+ + + +-+-+-+ +-+-+-+ + +
|     |     | | | |         |       |   |
+-+ + + + + + + + +-+-+ + +-+-+-+ +-+-+ +
| | |   | | | |   |     |   |     |   | |
+ + +-+ +-+-+ +-+ +-+ +-+-+-+ + +-+ +-+-+
|   |         |   |       |   | |   |   |
+ +-+-+ + +-+-+-+ +-+-+-+-+-+ +-+-+ + +-+
|   | | |     | |   | |   | |         | |
+ +-+ + + +-+-+ + +-+ + +-+ + +-+-+-+ + +
| |     | | |     |       |     | |     |
+-+ +-+ + + + +-+ +-+-+ +-+-+-+ + +-+-+-+
|   |   | |   |     |     |       |     |
+-+ +-+ + +-+ +-+ + + +-+ + +-+-+-+-+ + +
| |   | | | | | | |   | | |   | | | | | |
+ + + +-+-+ + + +-+-+-+ +-+-+ + + + +-+ +
| | |       | |         |               |
+ + +-+-+-+-+ + + +-+ +-+-+ +-+-+ +-+ +-+
|       | |   | |   | |     |   | |     |
+ + +-+ + + + + +-+-+-+ +-+ + +-+ +-+ +-+
| | |   | | |             | |   |   |   |
+ + +-+ + +-+-+ +-+-+ + + + + +-+ +-+ + +
| | |     | | | | | | | | |     | |   | |
+-+-+ +-+-+ + + + + +-+-+ +-+-+-+-+-+-+ +
| |   |     |     |   |         | |   | |
+ +-+-+ + + + + + +-+ +-+ +-+ +-+ + +-+-+
|   |   | |   | |   |       |     |     |
+ +-+-+ + +-+-+-+-+ +-+ +-+-+ +-+-+ +-+ +
|   |   |     |   |   | |   | | | |   | |
+ + + +-+-+ +-+-+ +-+-+ + + + + + + +-+ +
| |   |     |   |     |   | | |     | | |
+ +-+-+-+-+ +-+ +-+ +-+-+-+-+ + +-+ + +-+
|         | |               |     | |   |
+ + + +-+-+-+-+ + + +-+ +-+-+-+ +-+ + + +
| | |     |     | | | |   | | | |     | |
+ +-+-+ +-+ +-+-+ +-+ + +-+ + + + + +-+ +
|     |   |   |   |             | |   | |
+-+-+-+-+-+-+-+-+-+-+-+-+-+-+-+-+-+-+-+-+
