30
30
+-+-+-+-+-+-+-+-+-+-+-+-+-+-+-+-+-+-+-+-+-+-+-+-+-+-+-+-+-+-+
|   | |           |     |       |       | | |           |   |
+-+ + + + +-+-+-+-+ +-+-+ + +-+ + +-+-+-+ + +-+-+ + +-+-+ +-+
| | |   | |         |   | | |       |   |   | |   |   |     |
+ + + +-+ +-+-+ + + + +-+ +-+-+-+ +-+ + +-+ + +-+-+-+ +-+ +-+
|     |     |   | |   |         |   | | |     |   | | | | | |
+ +-+-+-+ +-+ + + + + +-+-+-+ + +-+ + +-+ + +-+ +-+ + + + + +
| | | |   |   | | | | |   | | | | |   |   |         |   |   |
+-+ + +-+ +-+ + +-+-+ +-+ + +-+-+ + + + + +-+-+ + +-+ + + +-+
| |   |   |   |   | |     | | |     |   | |     |   | |   | |
+ + +-+ + + +-+-+-+ +-+ + + + + + +-+ +-+-+ +-+ +-+ +-+-+ + +
|   |   |   |           | | |   | |     | | |     |         |
+-+ +-+-+-+-+ +-+ +-+-+-+ + + +-+-+ +-+ + +-+ +-+-+-+-+-+-+-+
| |   |       | |   | |       | |   |   |             |     |
+ + +-+ +-+-+ + + + + +-+ +-+ + +-+ +-+ +-+ +-+ +-+ +-+-+-+ +
|       |   | |   | |     |   | |   |   | | |     |   |     |
+ +-+-+ + +-+ + + +-+-+-+-+ + + +-+-+ +-+ +-+-+ +-+ +-+-+ + +
| |   | | |   | |     | |   | |       |   | |     |       | |
+ +-+ + + + +-+ +-+ +-+ +-+-+-+ +-+-+-+ +-+ + + +-+-+ + +-+-+
| | |     | |     |   |       | | |         | | |   | |   | |
+ + + + +-+ + + + +-+-+ + + + + + +-+-+ + +-+ +-+ +-+-+-+-+ +
| | | | | | | | | | |   | | |   |   |   | | |   | |       | |
+ + +-+ + +-+-+-+ + +-+ +-+-+ +-+ +-+ +-+-+ +-+-+ +-+ + + + +
| |   |   |       |   | |   |   |     | |       | |   | |   |
+ + +-+ +-+ +-+ +-+ +-+ + +-+ +-+ +-+ + + +-+-+ + + +-+ + + +
|     |   | |     |   | |         | |       | | |   |   | | |
+ +-+-+-+-+-+-+-+ +-+ +-+-+-+-+ + + + +-+-+-+ + + + +-+-+-+-+
|   |     |       |     |     | |   | |       |   |         |
+-+ +-+-+ + + +-+-+-+ +-+-+-+ + +-+ +-+-+ +-+ +-+-+-+ +-+ +-+
|   |       |   | | |         |   |         |       | |     |
+-+-+-+-+-+-+ + + + +-+-+-+-+ +-+-+ +-+ +-+-+ + +-+-+-+-+ +-+
|   |   |     |   | |     |     | | |     |   |     |       |
+-+ + + +-+ + +-+-+ +-+ +-+ +-+ + + +-+-+-+-+-+-+ + + +-+ +-+
|     |     |   | |   |     |   |   | | |   | |   | |   | | |
+ + +-+ +-+ + +-+ + +-+ +-+-+-+ +-+ + + + +-+ +-+-+ + +-+-+ +
| | |   |   | | |   |       | |                   | | | |   |
+-+-+ + +-+-+-+ + + + +-+-+-+ +-+-+ + + + +-+-+ + +-+ + +-+ +
|   | | |   |     |     | |     |   | | |   |   | | | |     |
+-+ + +-+ +-+ +-+ +-+-+ + + +-+ +-+-+-+ +-+-+-+-+-+ +-+ + + +
| |     | | |   | |         | |   |         |       | | | | |
+ + +-+ + + +-+ +-+ + +-+-+ + +-+ +-+-+-+ + +-+-+ +-+ + + +-+
|   |   |       |   |     |   | | |   |   | |   |     | |   |
+-+ +-+ +-+ + +-+-+ + +-+ + +-+ +-+ +-+ + +-+ +-+ +-+-+-+-+ +
| | |     | | |   | | |   |       | |   |         |         |
+ +-+-+-+-+-+-+-+ +-+-+ +-+-+ + +-+ +-+ +-+-+ +-+-+-+ + + + +
|         | |     | |     | | | |     |     | |     | | | | |
+-+-+-+ + + + +-+ + +-+ +-+ +-+-+-+ + +-+ +-+-+-+ + + + + +-+
|       | | | |           |     |   | |   |     | |   | |   |
+-+-+ +-+ + + + + +-+ +-+-+-+-+ + +-+-+ +-+ + + +-+ +-+-+ +-+
|     | |   | | |   |     | |     | |       | |       |     |
+ + + + +-+ +-+-+-+ +-+ + + + +-+ + + + + + + + +-+ +-+ +-+ +
| | |     | |   | | |   | |     | |   | | | | |   |   | |   |
+ + +-+-+-+ + + + + + +-+-+-+-+ +-+ +-+ + +-+-+ + +-+-+-+-+-+
| | |   |   | |     | |   |       |   | |   |   |   |     | |
+ +-+ + + + + +-+-+ + +-+ + +-+-+ + + +-+ +-+ +-+-+ +-+ +-+ +
| | | |   | | |     |       |     | |   | | | | | |   |   | |
+-+ +-+-+-+ +-+ +-+ + +-+-+ +-+-+-+-+ +-+-+ + + + +-+ + + + +
|   |   |         | | | |       | |       |   |   |     |   |
+ +-+-+ +-+ +-+-+ + + + + +-+-+-+ + +-+-+-+-+-+ +-+ + +-+ +-+
|               | | |   |       |         |         | |     |
+-+-+-+-+-+-+-+-+-+-+-+-+-+-+-+-+-+-+-+-+-+-+-+-+-+-+-+-+-+-+
