40
40
+-+-+-+-+-+-+-+-+-+-+-+-+-+-+-+-+-+-+-+-+-+-+-+-+-+-+-+-+-+-+-+-+-+-+-+-+-+-+-+-+
|   |   |   | | |     |     |         | |     |     |   | | | |       |         |
+-+ + + +-+ + + +-+ +-+-+-+ + +-+ +-+ + +-+ + +-+ +-+-+ + + + + +-+ +-+ + + + + +
|     | |           |     |   |     | | |   | |           |       |   | | | | | |
+ + + +-+-+ +-+ +-+-+-+ +-+ +-+ + + +-+ +-+ + +-+-+ +-+-+-+ +-+ + +-+-+-+ +-+-+ +
| | |   |   |     |       | |   | |   |     | | | |         |   |   |       | | |
+-+-+-+ + +-+-+-+ + + + + + +-+-+-+-+-+-+-+ +-+ + + +-+-+-+-+-+-+-+ + +-+-+-+ +-+
| | |   | |   | | | | | | |     | |   | | |         |   |       |       |   |   |
+ + + +-+ + +-+ +-+-+ +-+ + + +-+ +-+ + + +-+ +-+-+-+-+ +-+ +-+-+-+ +-+-+ +-+ + +
|   |   |     |         | | |   |       |   |     |   |       |               | |
+ +-+-+ + + +-+-+ +-+ + +-+ +-+-+ +-+-+-+ + + + +-+-+ +-+ +-+-+-+ +-+-+ +-+-+-+ +
|       | |   |   |   | |         |   |   |   |     |                 |   | | | |
+-+ +-+ +-+ +-+-+ + +-+ + +-+ +-+-+ +-+-+ + +-+ + +-+ + +-+-+-+-+ + +-+-+ + + + +
|     | | | | |   | |   | |           |   |   | |   | | |     |   |     |   | | |
+ + + +-+ + + +-+ +-+ + + +-+ +-+-+ +-+ +-+ +-+ +-+ + +-+-+ + +-+ +-+-+ +-+-+ +-+
| | |         | | |   |     |   | |     |     |   | | |     | |     |   |       |
+ +-+ +-+-+-+ + +-+ +-+-+ +-+-+-+ +-+ + +-+-+-+ +-+-+ + +-+-+-+-+ +-+-+-+ +-+-+-+
| |   | | |   |     |     | |       | | |       | |     | | |     |       |     |
+-+ + + + + +-+-+ +-+-+-+ + +-+ + + + +-+-+-+ +-+ +-+-+ + + + +-+-+-+ +-+ +-+-+ +
|   |   |     | |   |     |     | | |     | | | |   | |   |     |     | | | |   |
+ +-+-+-+-+ +-+ +-+-+ +-+ + +-+ +-+ +-+-+ + +-+ + + + + +-+-+ +-+ + +-+ + + + +-+
|     |       | |   | |     |     | |     |   |   |   |   |     | | | |         |
+-+-+-+-+-+-+ + + +-+-+ +-+ + +-+ +-+-+-+ + +-+ +-+-+ +-+ +-+-+ + +-+ +-+-+-+ +-+
|   |               |   |   | |   |       |         | |   | | | |   |   | |     |
+ + + +-+ +-+ + +-+ +-+-+-+-+-+ +-+ +-+-+-+ +-+-+ +-+ + +-+ + +-+-+ + + + +-+-+-+
| |   |   | | | | |           | |     | | |   |   | |           |   | | |   | | |
+-+ +-+-+-+ +-+-+ + + +-+-+ + +-+-+ + + + +-+-+-+-+ + + + +-+-+-+-+ +-+ +-+ + + +
| |   |       |     |   | | | |     | | |   | |       | |         |   | |       |
+ +-+ +-+-+-+ + + +-+ +-+ +-+ + + +-+-+ + + + +-+ + +-+ +-+-+ + +-+-+ + +-+-+ + +
| | | | | |     |   | | | |     | |       | | | | |   | |   | |   |           | |
+ + + + + + +-+ +-+ +-+ + +-+ + +-+-+-+-+ + + + +-+ +-+ +-+ +-+ +-+-+-+-+ +-+ +-+
|     |   |   |   |   |       |   |     | |     |     | | | |   |     | |   |   |
+-+-+ + +-+-+ +-+-+ +-+-+-+-+-+ +-+-+-+ +-+ + + +-+ +-+-+ + + + + +-+-+ + +-+-+-+
|   |       | | |       |       | | |   |   | |   |   | |     | | |         |   |
+ + + + +-+-+-+ +-+-+ + +-+ +-+-+ + +-+ + +-+ +-+-+ +-+ + + +-+-+ +-+ +-+ + + +-+
| | | |           | | | |   |           |   |   | | | | | |           |   |   | |
+-+ +-+-+ +-+-+-+ + + +-+-+ + + +-+ +-+ + +-+-+-+ +-+ + +-+ +-+-+-+ +-+ +-+-+ + +
|   | |     |   | |   | | |   |   |   |   | |       |     |   | |   |   | |   | |
+-+ + +-+-+ + + +-+ +-+ + + + +-+-+ +-+-+-+ +-+ + + +-+ + + +-+ + +-+-+-+ + +-+ +
|     | |     |   | |       |   | | | |   |     | | | | | |   |   | |           |
+-+ + + + +-+ + +-+-+-+ + +-+ +-+ +-+ + + + +-+-+-+-+ +-+ +-+-+-+ + +-+ + +-+-+-+
|   | |     | | |     | | |   |     |   | |       |   | |       |   | | | |   | |
+ +-+-+ +-+-+-+-+-+-+ + +-+-+-+-+-+ +-+-+ +-+ +-+-+ + + +-+ +-+ + +-+ + +-+ +-+ +
|           |   |         |               |     | | | |     | | |     |         |
+-+ +-+-+-+ +-+ +-+-+ +-+-+ + +-+ +-+-+ +-+-+ +-+ + + + +-+ + +-+-+-+-+ + + + +-+
| |   |     | | |   |     | | |     |               | | |   |   | | |   | | |   |
+ + + +-+ +-+ + + +-+-+ + +-+-+-+ +-+-+-+ +-+-+-+-+ +-+ + + + +-+ + + +-+ +-+ +-+
|   | |   | |     |     | |   | |     |   |     |   |   | | |   |   | |   |     |
+-+ +-+-+-+ + + +-+ + +-+ +-+ + +-+-+-+ +-+-+-+ + +-+-+ +-+-+-+ +-+ + + +-+ +-+-+
|   |       | | | | | |             | | | |         |   | | | | | | | | | | |   |
+ + +-+ +-+ +-+ + +-+-+-+-+ + + + +-+ +-+ + +-+ + + + + + + + + + + + + + +-+ +-+
| | | |   |     |           | | | | | | | |   | | |   |   | | |     | | |       |
+-+ + +-+-+ +-+ +-+-+ +-+-+ +-+ +-+ + + + +-+-+-+-+-+ + +-+ + +-+ +-+ +-+ +-+-+ +
|   |       |     |     |   |   |             |       | |   |         |     |   |
+ + +-+-+-+ +-+-+-+-+-+-+ +-+ +-+ + +-+-+ +-+-+ +-+-+-+-+-+ + + +-+ +-+-+ +-+ +-+
| | | |   |           |     | | | |     |   |         | | |   | |       | | | | |
+-+ + + + +-+-+ +-+-+-+-+-+ +-+ +-+-+ + +-+ + +-+-+ + + + +-+-+ +-+-+ +-+ + +-+ +
|   |   |         |       | |         | | | | |     |   |     | |   |         | |
+-+-+ +-+ + +-+-+-+-+-+-+ + + + + + + +-+ +-+-+ +-+ +-+-+ +-+-+ + + + + +-+-+-+ +
|   | | | |       |   |     | | | | |   |   | | | | |   |   |     | | |         |
+ +-+-+ +-+ +-+-+ + +-+-+-+ +-+ + +-+ +-+-+ + + + +-+-+ + + + +-+ +-+ +-+-+ +-+ +
|         | |             | | | | |     |       | |   |   |   |     | |   | | | |
+ + +-+-+ + +-+-+ +-+-+ +-+ + + +-+-+ + +-+-+-+ + + + + +-+-+ + +-+-+-+-+ + + + +
| |     |       | | | | |   | |   | | |             | |   |   | | |           | |
+-+-+-+-+-+-+-+ + + + + +-+ + + +-+ +-+-+-+-+-+-+-+-+ +-+ +-+-+-+ +-+ + +-+-+-+-+
| |   |   | | | | | |   | |   |               | |       | |         | | | | |   |
+ +-+ + + + + + + + +-+ + + +-+ +-+ +-+ +-+-+-+ +-+ + + + +-+-+-+ +-+ + + + +-+ +
|       | |     |   |         |   | |   |           | | | |   |   |   | | |     |
+-+-+ +-+-+ + +-+ +-+-+-+ +-+ +-+-+-+ +-+-+-+ + +-+-+-+-+ +-+ +-+ + + +-+ + +-+ +
|       | | | |   | |       | |     | | |     |   |   | |         | |         | |
+ +-+ +-+ +-+ +-+-+ +-+ +-+ +-+ + +-+ + + +-+-+ + + + + +-+-+-+ +-+-+ + +-+ + +-+
|   |     |   |       |   | | | | |     | | |   |   |         |   |   |   | |   |
+ +-+-+ +-+ +-+ +-+-+-+-+ +-+ +-+ +-+-+ + + + + +-+-+ +-+-+ +-+ +-+ +-+-+-+-+ +-+
|   | | |     | | |   |       |   | |   |   | | |       |         |       |     |
+-+-+ + +-+ + + + + +-+-+ +-+-+-+ + +-+-+ + +-+ + + +-+ +-+-+ + +-+ +-+-+-+-+-+ +
| |         |         |     |       | |   | |   | |   |     | |   |     |       |
+ + +-+ + +-+ +-+-+-+-+ +-+ + +-+ + + +-+-+ +-+ +-+ + + + +-+-+-+-+-+ +-+ + +-+-+
|   |   | | |   | |   | | |   |   |   |     |     | | | | |     |   |   | |     |
+ +-+-+ +-+ + +-+ +-+ + + +-+ + +-+-+ +-+ + + + +-+ +-+-+ + + + + +-+-+-+ +-+ + +
|     |   |     |         |   |   |   |   | | | |       |   | | |         |   | |
+-+-+-+-+-+-+-+-+-+-+-+-+-+-+-+-+-+-+-+-+-+-+-+-+-+-+-+-+-+-+-+-+-+-+-+-+-+-+-+-+
