10
10
+-+-+-+-+-+-+-+-+-+-+
|   |       |       |
+ + +-+ +-+ +-+ + + +
| |       |     | | |
+-+ +-+ +-+ + + + +-+
| | |   | | | | |   |
+ +-+-+-+ +-+-+-+ + +
| | |   |   |   | | |
+ + + +-+ +-+ +-+ + +
| |     | |   | | | |
+ + +-+ + +-+ + + +-+
|     |     | |     |
+ +-+-+ +-+ + + +-+-+
| |   | |       |   |
+ + +-+ +-+ + + + +-+
| |     |   | | |   |
+-+-+ +-+-+ +-+ + + +
| |   | | | |     | |
+ +-+ + + +-+-+ +-+ +
|           |   |   |
+-+-+-+-+-+-+-+-+-+-+
