15
12
+-+-+-+-+-+-+-+-+-+-+-+-+-+-+-+
| |     | |   |     |   |   | |
+ + +-+-+ +-+ +-+-+ +-+ + +-+ +
|     | | |         | | | | | |
+ + + + + + +-+-+-+ + + + + + +
| | |   |         |           |
+-+-+ +-+-+ +-+-+-+ +-+ + +-+ +
|             | | |   | | | | |
+-+ + +-+-+-+-+ + +-+ +-+-+ + +
|   | |   |   |       |   | | |
+-+ +-+ + + + + +-+ +-+ +-+ + +
|   | | | | |   |   |   | |   |
+-+ + +-+ +-+-+ + + + +-+ +-+-+
| |   |   | |   | | |         |
+ + +-+ +-+ + + +-+ +-+-+-+ +-+
|       | |   |   | |   |     |
+ +-+-+ + + +-+ +-+-+ + + +-+-+
| |     | | | |     | |       |
+-+-+ +-+ +-+ + +-+ +-+ +-+-+ +
|   |     |   | |   | |     | |
+ +-+ +-+-+-+ + +-+-+ + +-+-+ +
|     | |               | |   |
+ +-+ + + +-+ +-+-+-+-+-+ +-+ +
| |     | |                 | |
+-+-+-+-+-+-+-+-+-+-+-+-+-+-+-+
