10
10
+-+-+-+-+-+-+-+-+-+-+
|       |   | |     |
+-+-+ +-+-+ + + + + +
|   |         | | | |
+-+ + + +-+-+ + +-+-+
| | | | |     | |   |
+ + +-+-+ +-+-+ +-+ +
|               |   |
+ + + +-+ + + + +-+ +
| | | |   | | | |   |
+-+ +-+ + + + + +-+ +
|     | | | | |     |
+-+ + +-+-+-+-+ + + +
| | | | |   | | | | |
+ + + + + +-+ + +-+-+
| | | |           | |
+ + +-+-+ + +-+ + + +
|   | |   |   | |   |
+ +-+ + + +-+ +-+-+ +
|   |   |   |   |   |
+-+-+-+-+-+-+-+-+-+-+
