40
40
+-+-+-+-+-+-+-+-+-+-+-+-+-+-+-+-+-+-+-+-+-+-+-+-+-+-+-+-+-+-+-+-+-+-+-+-+-+-+-+-+
|   | |   | |       |       |   | |       | |   | |     |   | |     |   |   |   |
+ +-+ + +-+ +-+-+ +-+ + +-+-+-+ + +-+ +-+ + + + + + +-+ + +-+ +-+ +-+ +-+-+ + +-+
|     |       |       |   | | | |     |     | | | | | |   | |     |     |   |   |
+-+-+ +-+-+ + +-+-+ +-+-+-+ + + +-+ + +-+ +-+ + + +-+ +-+ + + + +-+ + +-+ + + +-+
|     | | | |         |       |     | |   | | |   | |   |   | | |   |   | |     |
+ + + + + +-+-+ +-+-+ + +-+ +-+ +-+-+-+-+ + +-+ +-+ +-+ + +-+ +-+ + +-+-+ +-+-+ +
| | |       | |   | | | |   |   |     | | |   |   |               |   | |     | |
+-+ +-+-+-+-+ + + + + +-+ +-+ +-+ +-+-+ +-+ +-+ +-+ +-+-+ +-+-+ +-+-+ + + + +-+ +
| |   | | |     | |     |   | |   |     |     |     |   | |   |   | |     | |   |
+ + +-+ + +-+ +-+ +-+ +-+ + + +-+ + +-+ +-+ +-+-+-+ +-+ + + +-+-+-+ +-+-+ +-+-+-+
|   |           | |       |       |   |   |       |   | |       |       | |     |
+ + +-+-+-+-+-+ +-+-+-+ +-+ +-+-+-+-+-+ +-+ + +-+-+-+-+ + +-+ +-+-+ + +-+ + +-+-+
| |     | |     |     |   | | | | |   |   | | |       |   | |     | | |       | |
+-+-+-+ + +-+ +-+-+ +-+ +-+ + + + + +-+ + + + + + +-+ +-+-+ +-+ + +-+ +-+-+ +-+ +
| |     |   | |   |   |   |             |   | | |   |     | |   |   | |     |   |
+ + +-+ + +-+ + +-+-+ +-+-+-+-+-+-+ +-+ +-+ + + +-+-+-+ + + + +-+ + + +-+-+ + +-+
| | |       |       |   | |         |   |   | |   | |   |     | | | | | | |     |
+ + + + +-+-+-+ + +-+ + + +-+ +-+-+-+ + +-+ +-+ +-+ + +-+ +-+ + +-+-+ + + +-+ +-+
| | | | |   |   |     |   | | |       | | |     |   | | | |     |       | |     |
+ +-+ +-+ + +-+-+ + +-+-+ + +-+ +-+-+ + + +-+-+-+-+ +-+ +-+ + +-+-+-+-+ + +-+-+-+
|         | | | | | |   | |       | | | |   |   | |       | |   |               |
+-+ +-+-+-+-+ + +-+-+-+ +-+-+-+ +-+ +-+ + +-+-+ + +-+ +-+-+ + +-+-+-+ +-+ +-+ + +
| |     |   |       |     | |   | |     | | |       | |     |       |   | |   | |
+ + +-+-+ +-+ +-+-+ + + + + +-+-+ +-+ +-+ + + + +-+-+ + +-+-+-+ +-+ +-+ +-+-+ +-+
|     |     | |   | | | | | |   |   |       | |   |   | | |     | | |   |   | | |
+ +-+-+ +-+-+ + +-+ + +-+-+ +-+ +-+ + + +-+-+ + + + + +-+ +-+-+ + + +-+ +-+ +-+ +
| | |   | | | |     |   | |       |   | |     | |   |     |   | |     |     |   |
+ + + + + + +-+-+ +-+ +-+ + +-+-+-+-+-+-+-+ +-+-+-+ +-+ + +-+ +-+-+-+ +-+ +-+-+ +
|     | |         |   | | |   | | |   | |     | |     | |       |           |   |
+-+-+-+ +-+ + +-+-+ +-+ + +-+ + + + +-+ + +-+ + +-+ + +-+ + +-+-+ + +-+ +-+-+ + +
|       |   |   |                 | |     |   |   | | | | | | |   | | |   |   | |
+-+ + + + +-+ + +-+ + + +-+-+ + +-+ + +-+ +-+ +-+ +-+-+ + +-+ + + + + + + + +-+-+
| | | | |   | | |   | |   | | |     | | |   | |           |   | | | |   | |     |
+ + + +-+ +-+-+-+ + + + + + +-+ + +-+-+ +-+ +-+ +-+-+-+-+-+-+ +-+ +-+ + +-+-+ + +
| | | |     | |   | | | |   | | | | | |   |   |       |   | |   |   | |   |   | |
+ + + + +-+ + + + +-+-+-+-+-+ + + + + + +-+-+-+-+ +-+ + +-+ + +-+-+-+-+ + + + + +
|   | |   |     | | |   |     | | |             | |                   | | | | | |
+-+ +-+ + +-+ +-+ + +-+ + +-+ + +-+-+ + + +-+ + + + + +-+-+ +-+ +-+-+-+-+ +-+-+ +
|     | |   | | |       | |       |   | |   | |   | | |   | |     |       |   | |
+-+ +-+-+-+ +-+ +-+ + + + +-+-+ +-+ + +-+ +-+-+-+ +-+-+-+ +-+-+ + + + +-+ + + + +
| | | |     |       | | | | | |     | | |   | |   |   |   | |   |   |   | | |   |
+ + + + + + + +-+-+ +-+-+ + + +-+ +-+-+ + + + + +-+ +-+-+ + + +-+-+ +-+-+-+-+ +-+
|   |   | | |   | | |   |   | | |   | | | |   |   |       |     | |         | | |
+ +-+ +-+-+-+-+-+ + + + +-+-+ + + +-+ + +-+-+ +-+-+-+ +-+-+-+-+-+ +-+-+-+ + + + +
| |   | |     |   |   | | |   | |   |     | | |   |           | |   |   | | |   |
+ +-+ + + +-+ +-+ +-+-+-+ + + + + +-+ +-+-+ +-+ +-+-+ + + +-+-+ +-+ + +-+ + + +-+
| | | | | | |   | |       | |   |     |   |   |   |   | |     | |     |   | |   |
+ + + + + + +-+ + + + +-+-+-+-+ + +-+-+ +-+-+ +-+ +-+ +-+-+ +-+ +-+-+ +-+ +-+-+ +
|         |   |   | | |     | | | |   |   |   |   | | |           |   |       | |
+ + + +-+ + + + +-+ + + +-+-+ + + + + +-+ +-+ + +-+ +-+-+-+-+-+ +-+-+ + +-+-+ + +
| | |   | | |     | | |   |     | | |   |                   |       |   |       |
+ +-+-+-+-+-+ + +-+-+ +-+ +-+ + + + + + + +-+-+-+-+-+-+ +-+-+ +-+-+-+-+ + +-+ + +
| | | | | |   |         |   | |   | | |     | | | |     | |     | |     | |   | |
+-+ + + + + +-+ +-+-+-+-+ + +-+-+ + +-+ +-+-+ + + +-+ +-+ + + +-+ + +-+ +-+-+ +-+
|   |   | | |     |       | |   |   |   |     |     |       |   |     | |   |   |
+ + + +-+ + +-+-+ +-+-+ +-+-+ +-+ + + + + +-+-+ +-+ +-+ +-+ +-+-+-+ +-+ +-+ +-+ +
| |   | |   |       |   | |       | | | | | | |   |     |         |   | | |   | |
+-+-+ + + + +-+-+-+-+-+ + + +-+ + +-+-+-+ + + + +-+ + + +-+ + +-+-+-+-+-+ + +-+ +
|     |   | |     | | |       | |   |     |   | |   | | |   | | |     |       | |
+ + +-+ +-+-+-+ + + + + + +-+-+ + +-+ +-+ +-+ +-+-+-+-+ +-+-+-+ +-+-+ + + +-+ + +
| | |     | |   |     | | | | | |     |             | |   | | |     | | |   | | |
+ + +-+ +-+ +-+ + +-+-+-+ + + + +-+-+ +-+-+-+-+-+-+ + + +-+ + +-+-+ + + +-+-+ + +
| |   | |     | | | |     |     |   | | |         | |       |   | |         |   |
+ +-+-+ + + +-+-+ + +-+ + +-+ +-+ +-+-+ +-+ +-+ + + +-+ +-+-+ + + + + +-+-+ +-+ +
|   | |   | | |       | | | |   |   |   | | |   | | |         |   | |   | |   | |
+ + + +-+-+-+ +-+-+ + + + + + + +-+ + + + +-+ +-+ +-+ + +-+ +-+-+-+ +-+-+ + + +-+
| | |   | |   | | | | | | |   |   |   |     | |     | |   |       | |   |   | | |
+-+ +-+ + + + + + + +-+-+-+-+-+ +-+ +-+-+ +-+-+-+ +-+ +-+ + + + +-+ + + +-+-+ + +
|   |     | |   |         | |       |   |   |     |     | | | | | |   |     |   |
+ + + + +-+-+ +-+-+-+-+ +-+ + +-+-+-+-+ + +-+ + +-+ +-+ +-+-+-+ + +-+ + + +-+-+ +
| | | |   | |           | |   |         |     | |   |         | | |   | |   |   |
+ +-+ + + + +-+-+-+-+ +-+ + + +-+ + +-+ +-+-+-+-+ + +-+-+-+ +-+-+ +-+ +-+ +-+-+ +
| |   | | |     |       |   | |   | |     |   | | |   | |   | |     | |       | |
+ +-+ +-+ +-+ +-+ + + +-+-+-+-+ +-+ + +-+-+ +-+ +-+ +-+ +-+ + +-+-+ + +-+ + +-+ +
| |     |   |   | | | |       | |   |                   |   |           | |   | |
+ + +-+ + + + +-+ + + +-+-+ +-+ + +-+-+ + +-+ +-+ +-+-+-+-+ + +-+-+-+-+-+ + +-+ +
| | |   | |   |   | |         | | |   | |   | | |   | |     | | |   |     | |   |
+ + +-+ + + +-+ + +-+-+-+-+ + + +-+ + + + +-+-+ + + + +-+-+ + + +-+ + + + +-+-+ +
|   |   | |     |   |       |   |   |   |       | |   |     | |       | |   |   |
+-+-+-+-+-+-+-+-+-+-+-+-+-+-+-+-+-+-+-+-+-+-+-+-+-+-+-+-+-+-+-+-+-+-+-+-+-+-+-+-+
